ID	Bacteria	Genus	Gram_Stain
AgProtect_2300	Mycobacterium_tuberculosis	Mycobacterium	Positive_with_OM
AgProtect_999	Streptococcus_uberis	Streptococcus	Positive
AgProtect_998	Borreliella_garinii	Borreliella	Negative
AgProtect_997	Borreliella_garinii	Borreliella	Negative
AgProtect_996	Borreliella_garinii	Borreliella	Negative
AgProtect_995	Mycobacterium_kansasii	Mycobacterium	Positive_with_OM
AgProtect_994	Mycobacterium_marinum	Mycobacterium	Positive_with_OM
AgProtect_993	Burkholderia_cenocepacia	Burkholderia	Negative
AgProtect_992	Ornithobacterium_rhinotracheale	Ornithobacterium	Negative
AgProtect_991	Leptospira_interrogans	Leptospira	Negative
AgProtect_990	Bartonella_bacilliformis	Bartonella	Negative
AgProtect_99	Brucella_abortus	Brucella	Negative
AgProtect_989	Bartonella_bacilliformis	Bartonella	Negative
AgProtect_988	Yersinia_enterocolitica	Yersinia	Negative
AgProtect_987	Yersinia_enterocolitica	Yersinia	Negative
AgProtect_986	Yersinia_enterocolitica	Yersinia	Negative
AgProtect_985	Acinetobacter_baumannii	Acinetobacter	Negative
AgProtect_984	Acinetobacter_baumannii	Acinetobacter	Negative
AgProtect_983	Borrelia_miyamotoi	Borrelia	Negative
AgProtect_982	Borrelia_miyamotoi	Borrelia	Negative
AgProtect_981	Borrelia_miyamotoi	Borrelia	Negative
AgProtect_980	Borrelia_miyamotoi	Borrelia	Negative
AgProtect_98	Brucella_abortus	Brucella	Negative
AgProtect_979	Borrelia_miyamotoi	Borrelia	Negative
AgProtect_978	Borrelia_miyamotoi	Borrelia	Negative
AgProtect_977	Borrelia_miyamotoi	Borrelia	Negative
AgProtect_976	Borrelia_miyamotoi	Borrelia	Negative
AgProtect_975	Acinetobacter_baumannii	Acinetobacter	Negative
AgProtect_974	Actinobacillus_pleuropneumoniae	Actinobacillus	Negative
AgProtect_973	Acinetobacter_baumannii	Acinetobacter	Negative
AgProtect_972	Escherichia_coli	Escherichia	Negative
AgProtect_971	Escherichia_coli	Escherichia	Negative
AgProtect_970	Escherichia_coli	Escherichia	Negative
AgProtect_97	Brucella_melitensis	Brucella	Negative
AgProtect_969	Escherichia_coli	Escherichia	Negative
AgProtect_968	Escherichia_coli	Escherichia	Negative
AgProtect_967	Escherichia_coli	Escherichia	Negative
AgProtect_966	Escherichia_coli	Escherichia	Negative
AgProtect_965	Escherichia_coli	Escherichia	Negative
AgProtect_964	Escherichia_coli	Escherichia	Negative
AgProtect_963	Escherichia_coli	Escherichia	Negative
AgProtect_962	Escherichia_coli	Escherichia	Negative
AgProtect_961	Escherichia_coli	Escherichia	Negative
AgProtect_960	Escherichia_coli	Escherichia	Negative
AgProtect_96	Brucella_melitensis	Brucella	Negative
AgProtect_959	Erysipelothrix_rhusiopathiae	Erysipelothrix	Positive
AgProtect_958	Erysipelothrix_rhusiopathiae	Erysipelothrix	Positive
AgProtect_957	Erysipelothrix_rhusiopathiae	Erysipelothrix	Positive
AgProtect_956	Erysipelothrix_rhusiopathiae	Erysipelothrix	Positive
AgProtect_955	Corynebacterium_diphtheriae	Corynebacterium	Positive_with_OM
AgProtect_954	Clostridium_perfringens	Clostridium	Positive
AgProtect_953	Clostridium_perfringens	Clostridium	Positive
AgProtect_952	Mycobacterium_tuberculosis	Mycobacterium	Positive_with_OM
AgProtect_951	Clostridium_perfringens	Clostridium	Positive
AgProtect_950	Clostridium_perfringens	Clostridium	Positive
AgProtect_95	Brucella_melitensis	Brucella	Negative
AgProtect_949	Clostridium_perfringens	Clostridium	Positive
AgProtect_948	Clostridium_perfringens	Clostridium	Positive
AgProtect_947	Clostridium_botulinum	Clostridium	Positive
AgProtect_946	Clostridium_botulinum	Clostridium	Positive
AgProtect_945	Clostridium_botulinum	Clostridium	Positive
AgProtect_944	Clostridium_botulinum	Clostridium	Positive
AgProtect_943	Clostridium_botulinum	Clostridium	Positive
AgProtect_942	Clostridium_botulinum	Clostridium	Positive
AgProtect_941	Chlamydia_psittaci	Chlamydia	Negative
AgProtect_940	Chlamydia_psittaci	Chlamydia	Negative
AgProtect_94	Borreliella_burgdorferi	Borreliella	Negative
AgProtect_939	Chlamydia_psittaci	Chlamydia	Negative
AgProtect_938	Chlamydia_trachomatis	Chlamydia	Negative
AgProtect_937	Chlamydia_trachomatis	Chlamydia	Negative
AgProtect_936	Campylobacter_jejuni	Campylobacter	Negative
AgProtect_935	Campylobacter_jejuni	Campylobacter	Negative
AgProtect_934	Campylobacter_jejuni	Campylobacter	Negative
AgProtect_933	Campylobacter_jejuni	Campylobacter	Negative
AgProtect_932	Campylobacter_lari	Campylobacter	Negative
AgProtect_931	Campylobacter_jejuni	Campylobacter	Negative
AgProtect_930	Campylobacter_jejuni	Campylobacter	Negative
AgProtect_93	Neisseria_meningitidis	Neisseria	Negative
AgProtect_929	Campylobacter_jejuni	Campylobacter	Negative
AgProtect_928	Campylobacter_jejuni	Campylobacter	Negative
AgProtect_927	Campylobacter_jejuni	Campylobacter	Negative
AgProtect_926	Campylobacter_jejuni	Campylobacter	Negative
AgProtect_925	Campylobacter_jejuni	Campylobacter	Negative
AgProtect_924	Campylobacter_jejuni	Campylobacter	Negative
AgProtect_923	Campylobacter_jejuni	Campylobacter	Negative
AgProtect_922	Campylobacter_jejuni	Campylobacter	Negative
AgProtect_921	Campylobacter_jejuni	Campylobacter	Negative
AgProtect_920	Campylobacter_jejuni	Campylobacter	Negative
AgProtect_92	Helicobacter_pylori	Helicobacter	Negative
AgProtect_919	Campylobacter_jejuni	Campylobacter	Negative
AgProtect_918	Brucella_abortus	Brucella	Negative
AgProtect_917	Bordetella_pertussis	Bordetella	Negative
AgProtect_916	Bordetella_pertussis	Bordetella	Negative
AgProtect_915	Bordetella_pertussis	Bordetella	Negative
AgProtect_914	Bordetella_bronchiseptica	Bordetella	Negative
AgProtect_913	Bordetella_bronchiseptica	Bordetella	Negative
AgProtect_912	Bordetella_bronchiseptica	Bordetella	Negative
AgProtect_911	Bordetella_bronchiseptica	Bordetella	Negative
AgProtect_910	Bordetella_bronchiseptica	Bordetella	Negative
AgProtect_91	Helicobacter_pylori	Helicobacter	Negative
AgProtect_909	Bordetella_bronchiseptica	Bordetella	Negative
AgProtect_908	Bordetella_bronchiseptica	Bordetella	Negative
AgProtect_907	Bordetella_avium	Bordetella	Negative
AgProtect_906	Bordetella_avium	Bordetella	Negative
AgProtect_905	Bordetella_avium	Bordetella	Negative
AgProtect_904	Bordetella_avium	Bordetella	Negative
AgProtect_903	Bordetella_avium	Bordetella	Negative
AgProtect_902	Bacillus_anthracis	Bacillus	Positive
AgProtect_901	Mycobacterium_tuberculosis	Mycobacterium	Positive_with_OM
AgProtect_900	Bacillus_anthracis	Bacillus	Positive
AgProtect_90	Helicobacter_pylori	Helicobacter	Negative
AgProtect_9	Yersinia_pestis	Yersinia	Negative
AgProtect_899	Bacillus_anthracis	Bacillus	Positive
AgProtect_898	Vibrio_cholerae	Vibrio	Negative
AgProtect_897	Vibrio_cholerae	Vibrio	Negative
AgProtect_896	Vibrio_cholerae	Vibrio	Negative
AgProtect_895	Vibrio_cholerae	Vibrio	Negative
AgProtect_894	Vibrio_cholerae	Vibrio	Negative
AgProtect_893	Vibrio_cholerae	Vibrio	Negative
AgProtect_892	Vibrio_cholerae	Vibrio	Negative
AgProtect_891	Mycobacterium_leprae	Mycobacterium	Positive_with_OM
AgProtect_890	Mycobacterium_leprae	Mycobacterium	Positive_with_OM
AgProtect_89	Haemophilus_influenzae	Haemophilus	Negative
AgProtect_889	Mycobacterium_leprae	Mycobacterium	Positive_with_OM
AgProtect_888	Mycobacterium_leprae	Mycobacterium	Positive_with_OM
AgProtect_887	Mycobacterium_leprae	Mycobacterium	Positive_with_OM
AgProtect_886	Mycobacterium_leprae	Mycobacterium	Positive_with_OM
AgProtect_885	Mycobacterium_leprae	Mycobacterium	Positive_with_OM
AgProtect_884	Mycobacterium_leprae	Mycobacterium	Positive_with_OM
AgProtect_883	Mycobacterium_leprae	Mycobacterium	Positive_with_OM
AgProtect_882	Mycobacterium_leprae	Mycobacterium	Positive_with_OM
AgProtect_881	Mycobacterium_leprae	Mycobacterium	Positive_with_OM
AgProtect_880	Mycobacterium_leprae	Mycobacterium	Positive_with_OM
AgProtect_88	Brucella_abortus	Brucella	Negative
AgProtect_879	Mycobacterium_leprae	Mycobacterium	Positive_with_OM
AgProtect_878	Mycobacterium_tuberculosis	Mycobacterium	Positive_with_OM
AgProtect_877	Mycobacterium_tuberculosis	Mycobacterium	Positive_with_OM
AgProtect_876	Mycobacterium_tuberculosis	Mycobacterium	Positive_with_OM
AgProtect_875	Mycobacterium_tuberculosis	Mycobacterium	Positive_with_OM
AgProtect_874	Mycobacterium_tuberculosis	Mycobacterium	Positive_with_OM
AgProtect_873	Mycobacterium_tuberculosis	Mycobacterium	Positive_with_OM
AgProtect_872	Mycobacterium_tuberculosis	Mycobacterium	Positive_with_OM
AgProtect_871	Mycobacterium_tuberculosis	Mycobacterium	Positive_with_OM
AgProtect_870	Mycobacterium_tuberculosis	Mycobacterium	Positive_with_OM
AgProtect_87	Mycobacterium_tuberculosis	Mycobacterium	Positive_with_OM
AgProtect_869	Mycobacterium_tuberculosis	Mycobacterium	Positive_with_OM
AgProtect_868	Mycobacterium_tuberculosis	Mycobacterium	Positive_with_OM
AgProtect_867	Mycobacterium_tuberculosis	Mycobacterium	Positive_with_OM
AgProtect_866	Mycobacterium_tuberculosis	Mycobacterium	Positive_with_OM
AgProtect_865	Mycobacterium_tuberculosis	Mycobacterium	Positive_with_OM
AgProtect_864	Mycobacterium_tuberculosis	Mycobacterium	Positive_with_OM
AgProtect_863	Mycobacterium_tuberculosis	Mycobacterium	Positive_with_OM
AgProtect_862	Mycobacterium_tuberculosis	Mycobacterium	Positive_with_OM
AgProtect_861	Mycobacterium_tuberculosis	Mycobacterium	Positive_with_OM
AgProtect_860	Mycobacterium_tuberculosis	Mycobacterium	Positive_with_OM
AgProtect_86	Mycobacterium_tuberculosis	Mycobacterium	Positive_with_OM
AgProtect_859	Mycobacterium_tuberculosis	Mycobacterium	Positive_with_OM
AgProtect_858	Mycobacterium_tuberculosis	Mycobacterium	Positive_with_OM
AgProtect_857	Mycobacterium_tuberculosis	Mycobacterium	Positive_with_OM
AgProtect_856	Mycobacterium_tuberculosis	Mycobacterium	Positive_with_OM
AgProtect_855	Mycobacterium_tuberculosis	Mycobacterium	Positive_with_OM
AgProtect_854	Mycobacterium_tuberculosis	Mycobacterium	Positive_with_OM
AgProtect_853	Mycobacterium_tuberculosis	Mycobacterium	Positive_with_OM
AgProtect_852	Mycobacterium_tuberculosis	Mycobacterium	Positive_with_OM
AgProtect_851	Mycobacterium_tuberculosis	Mycobacterium	Positive_with_OM
AgProtect_850	Mycobacterium_tuberculosis	Mycobacterium	Positive_with_OM
AgProtect_85	Mycobacterium_tuberculosis	Mycobacterium	Positive_with_OM
AgProtect_849	Helicobacter_pylori	Helicobacter	Negative
AgProtect_848	Helicobacter_pylori	Helicobacter	Negative
AgProtect_847	Helicobacter_pylori	Helicobacter	Negative
AgProtect_846	Helicobacter_pylori	Helicobacter	Negative
AgProtect_845	Helicobacter_pylori	Helicobacter	Negative
AgProtect_844	Streptococcus_pneumoniae	Streptococcus	Positive
AgProtect_843	Streptococcus_pneumoniae	Streptococcus	Positive
AgProtect_842	Streptococcus_pneumoniae	Streptococcus	Positive
AgProtect_841	Pseudomonas_aeruginosa	Pseudomonas	Negative
AgProtect_840	Neisseria_meningitidis	Neisseria	Negative
AgProtect_84	Mycobacterium_tuberculosis	Mycobacterium	Positive_with_OM
AgProtect_839	Mycobacterium_tuberculosis	Mycobacterium	Positive_with_OM
AgProtect_838	Mycobacterium_tuberculosis	Mycobacterium	Positive_with_OM
AgProtect_837	Mycobacterium_tuberculosis	Mycobacterium	Positive_with_OM
AgProtect_836	Mycobacterium_tuberculosis	Mycobacterium	Positive_with_OM
AgProtect_835	Mycobacterium_tuberculosis	Mycobacterium	Positive_with_OM
AgProtect_834	Mycobacterium_tuberculosis	Mycobacterium	Positive_with_OM
AgProtect_833	Mycobacterium_tuberculosis	Mycobacterium	Positive_with_OM
AgProtect_832	Mycobacterium_tuberculosis	Mycobacterium	Positive_with_OM
AgProtect_831	Mycobacterium_tuberculosis	Mycobacterium	Positive_with_OM
AgProtect_830	Mycobacterium_tuberculosis	Mycobacterium	Positive_with_OM
AgProtect_83	Mycobacterium_tuberculosis	Mycobacterium	Positive_with_OM
AgProtect_829	Mycobacterium_tuberculosis	Mycobacterium	Positive_with_OM
AgProtect_828	Mycobacterium_tuberculosis	Mycobacterium	Positive_with_OM
AgProtect_827	Mycobacterium_tuberculosis	Mycobacterium	Positive_with_OM
AgProtect_826	Mycobacterium_leprae	Mycobacterium	Positive_with_OM
AgProtect_825	Mycobacterium_leprae	Mycobacterium	Positive_with_OM
AgProtect_824	Mycobacterium_leprae	Mycobacterium	Positive_with_OM
AgProtect_823	Mycobacterium_leprae	Mycobacterium	Positive_with_OM
AgProtect_822	Mycobacterium_leprae	Mycobacterium	Positive_with_OM
AgProtect_821	Mycobacterium_leprae	Mycobacterium	Positive_with_OM
AgProtect_820	Mycobacterium_leprae	Mycobacterium	Positive_with_OM
AgProtect_82	Mycobacterium_tuberculosis	Mycobacterium	Positive_with_OM
AgProtect_819	Mycobacterium_leprae	Mycobacterium	Positive_with_OM
AgProtect_818	Mycobacterium_leprae	Mycobacterium	Positive_with_OM
AgProtect_817	Mycobacterium_leprae	Mycobacterium	Positive_with_OM
AgProtect_816	Mycobacterium_leprae	Mycobacterium	Positive_with_OM
AgProtect_815	Mycobacterium_leprae	Mycobacterium	Positive_with_OM
AgProtect_814	Mycobacterium_leprae	Mycobacterium	Positive_with_OM
AgProtect_813	Mycobacterium_leprae	Mycobacterium	Positive_with_OM
AgProtect_812	Mycobacterium_leprae	Mycobacterium	Positive_with_OM
AgProtect_811	Mycobacterium_leprae	Mycobacterium	Positive_with_OM
AgProtect_810	Mycobacterium_leprae	Mycobacterium	Positive_with_OM
AgProtect_81	Mycobacterium_tuberculosis	Mycobacterium	Positive_with_OM
AgProtect_809	Mycobacterium_leprae	Mycobacterium	Positive_with_OM
AgProtect_808	Mycobacterium_leprae	Mycobacterium	Positive_with_OM
AgProtect_807	Mycobacterium_leprae	Mycobacterium	Positive_with_OM
AgProtect_806	Mycobacterium_leprae	Mycobacterium	Positive_with_OM
AgProtect_805	Mycobacterium_leprae	Mycobacterium	Positive_with_OM
AgProtect_804	Mycobacterium_leprae	Mycobacterium	Positive_with_OM
AgProtect_803	Mycobacterium_leprae	Mycobacterium	Positive_with_OM
AgProtect_802	Mycobacterium_leprae	Mycobacterium	Positive_with_OM
AgProtect_801	Mycobacterium_leprae	Mycobacterium	Positive_with_OM
AgProtect_800	Mycobacterium_leprae	Mycobacterium	Positive_with_OM
AgProtect_80	Mycobacterium_bovis	Mycobacterium	Positive_with_OM
AgProtect_8	Yersinia_pestis	Yersinia	Negative
AgProtect_799	Mycobacterium_leprae	Mycobacterium	Positive_with_OM
AgProtect_798	Mycobacterium_leprae	Mycobacterium	Positive_with_OM
AgProtect_797	Mycobacterium_leprae	Mycobacterium	Positive_with_OM
AgProtect_796	Mycobacterium_leprae	Mycobacterium	Positive_with_OM
AgProtect_795	Mycobacterium_leprae	Mycobacterium	Positive_with_OM
AgProtect_794	Mycobacterium_leprae	Mycobacterium	Positive_with_OM
AgProtect_793	Mycobacterium_leprae	Mycobacterium	Positive_with_OM
AgProtect_792	Mycobacterium_leprae	Mycobacterium	Positive_with_OM
AgProtect_791	Mycobacterium_bovis	Mycobacterium	Positive_with_OM
AgProtect_790	Mycobacterium_bovis	Mycobacterium	Positive_with_OM
AgProtect_79	Escherichia_coli	Escherichia	Negative
AgProtect_789	Mycobacterium_bovis	Mycobacterium	Positive_with_OM
AgProtect_788	Mycobacterium_bovis	Mycobacterium	Positive_with_OM
AgProtect_787	Mycobacterium_bovis	Mycobacterium	Positive_with_OM
AgProtect_786	Mycobacterium_bovis	Mycobacterium	Positive_with_OM
AgProtect_785	Mycobacterium_bovis	Mycobacterium	Positive_with_OM
AgProtect_784	Mycobacterium_bovis	Mycobacterium	Positive_with_OM
AgProtect_783	Mycobacterium_bovis	Mycobacterium	Positive_with_OM
AgProtect_782	Mycobacterium_bovis	Mycobacterium	Positive_with_OM
AgProtect_781	Mycobacterium_bovis	Mycobacterium	Positive_with_OM
AgProtect_780	Mycobacterium_bovis	Mycobacterium	Positive_with_OM
AgProtect_78	Escherichia_coli	Escherichia	Negative
AgProtect_779	Mycobacterium_bovis	Mycobacterium	Positive_with_OM
AgProtect_778	Mycobacterium_bovis	Mycobacterium	Positive_with_OM
AgProtect_777	Vibrio_cholerae	Vibrio	Negative
AgProtect_776	Vibrio_cholerae	Vibrio	Negative
AgProtect_775	Helicobacter_pylori	Helicobacter	Negative
AgProtect_774	Helicobacter_pylori	Helicobacter	Negative
AgProtect_773	Helicobacter_pylori	Helicobacter	Negative
AgProtect_772	Helicobacter_pylori	Helicobacter	Negative
AgProtect_771	Helicobacter_pylori	Helicobacter	Negative
AgProtect_770	Helicobacter_pylori	Helicobacter	Negative
AgProtect_77	Brucella_melitensis	Brucella	Negative
AgProtect_769	Helicobacter_pylori	Helicobacter	Negative
AgProtect_768	Helicobacter_pylori	Helicobacter	Negative
AgProtect_767	Helicobacter_pylori	Helicobacter	Negative
AgProtect_766	Helicobacter_pylori	Helicobacter	Negative
AgProtect_765	Helicobacter_pylori	Helicobacter	Negative
AgProtect_764	Anaplasma_marginale	Anaplasma	Negative
AgProtect_763	Anaplasma_marginale	Anaplasma	Negative
AgProtect_762	Anaplasma_marginale	Anaplasma	Negative
AgProtect_761	Anaplasma_marginale	Anaplasma	Negative
AgProtect_760	Anaplasma_marginale	Anaplasma	Negative
AgProtect_76	Campylobacter_jejuni	Campylobacter	Negative
AgProtect_759	Anaplasma_marginale	Anaplasma	Negative
AgProtect_758	Borreliella_burgdorferi	Borreliella	Negative
AgProtect_757	Borreliella_burgdorferi	Borreliella	Negative
AgProtect_756	Borreliella_burgdorferi	Borreliella	Negative
AgProtect_755	Borreliella_burgdorferi	Borreliella	Negative
AgProtect_754	Borreliella_burgdorferi	Borreliella	Negative
AgProtect_753	Borreliella_burgdorferi	Borreliella	Negative
AgProtect_752	Borreliella_burgdorferi	Borreliella	Negative
AgProtect_751	Borreliella_burgdorferi	Borreliella	Negative
AgProtect_750	Borreliella_burgdorferi	Borreliella	Negative
AgProtect_75	Campylobacter_jejuni	Campylobacter	Negative
AgProtect_749	Brucella_abortus	Brucella	Negative
AgProtect_748	Brucella_abortus	Brucella	Negative
AgProtect_747	Brucella_abortus	Brucella	Negative
AgProtect_746	Brucella_abortus	Brucella	Negative
AgProtect_745	Brucella_abortus	Brucella	Negative
AgProtect_744	Brucella_abortus	Brucella	Negative
AgProtect_743	Brucella_abortus	Brucella	Negative
AgProtect_742	Brucella_abortus	Brucella	Negative
AgProtect_741	Brucella_abortus	Brucella	Negative
AgProtect_740	Brucella_abortus	Brucella	Negative
AgProtect_74	Mycobacterium_tuberculosis	Mycobacterium	Positive_with_OM
AgProtect_739	Brucella_melitensis	Brucella	Negative
AgProtect_738	Brucella_melitensis	Brucella	Negative
AgProtect_737	Chlamydia_trachomatis	Chlamydia	Negative
AgProtect_736	Chlamydia_trachomatis	Chlamydia	Negative
AgProtect_735	Chlamydia_trachomatis	Chlamydia	Negative
AgProtect_734	Chlamydia_trachomatis	Chlamydia	Negative
AgProtect_733	Chlamydia_trachomatis	Chlamydia	Negative
AgProtect_732	Chlamydia_trachomatis	Chlamydia	Negative
AgProtect_731	Chlamydia_trachomatis	Chlamydia	Negative
AgProtect_730	Chlamydia_trachomatis	Chlamydia	Negative
AgProtect_73	Mycobacterium_tuberculosis	Mycobacterium	Positive_with_OM
AgProtect_729	Clostridium_perfringens	Clostridium	Positive
AgProtect_728	Clostridium_perfringens	Clostridium	Positive
AgProtect_727	Clostridium_perfringens	Clostridium	Positive
AgProtect_726	Clostridium_perfringens	Clostridium	Positive
AgProtect_725	Clostridium_perfringens	Clostridium	Positive
AgProtect_724	Clostridium_perfringens	Clostridium	Positive
AgProtect_723	Clostridium_perfringens	Clostridium	Positive
AgProtect_722	Clostridium_perfringens	Clostridium	Positive
AgProtect_721	Clostridium_perfringens	Clostridium	Positive
AgProtect_720	Clostridium_tetani	Clostridium	Positive
AgProtect_72	Mycobacterium_tuberculosis	Mycobacterium	Positive_with_OM
AgProtect_719	Haemophilus_influenzae	Haemophilus	Negative
AgProtect_718	Haemophilus_influenzae	Haemophilus	Negative
AgProtect_717	Haemophilus_influenzae	Haemophilus	Negative
AgProtect_716	Haemophilus_influenzae	Haemophilus	Negative
AgProtect_715	Haemophilus_influenzae	Haemophilus	Negative
AgProtect_714	Haemophilus_influenzae	Haemophilus	Negative
AgProtect_713	Haemophilus_influenzae	Haemophilus	Negative
AgProtect_712	Haemophilus_influenzae	Haemophilus	Negative
AgProtect_711	Haemophilus_influenzae	Haemophilus	Negative
AgProtect_710	Haemophilus_influenzae	Haemophilus	Negative
AgProtect_71	Mycobacterium_tuberculosis	Mycobacterium	Positive_with_OM
AgProtect_709	Helicobacter_pylori	Helicobacter	Negative
AgProtect_708	Klebsiella_pneumoniae	Klebsiella	Negative
AgProtect_707	Klebsiella_pneumoniae	Klebsiella	Negative
AgProtect_706	Klebsiella_pneumoniae	Klebsiella	Negative
AgProtect_705	Legionella_pneumophila	Legionella	Negative
AgProtect_704	Legionella_pneumophila	Legionella	Negative
AgProtect_703	Legionella_pneumophila	Legionella	Negative
AgProtect_702	Legionella_pneumophila	Legionella	Negative
AgProtect_701	Legionella_pneumophila	Legionella	Negative
AgProtect_700	Legionella_pneumophila	Legionella	Negative
AgProtect_70	Mycobacterium_tuberculosis	Mycobacterium	Positive_with_OM
AgProtect_7	Yersinia_pestis	Yersinia	Negative
AgProtect_699	Listeria_monocytogenes	Listeria	Positive
AgProtect_698	Listeria_monocytogenes	Listeria	Positive
AgProtect_697	Listeria_monocytogenes	Listeria	Positive
AgProtect_696	Listeria_monocytogenes	Listeria	Positive
AgProtect_695	Listeria_monocytogenes	Listeria	Positive
AgProtect_694	Mycobacterium_avium	Mycobacterium	Positive_with_OM
AgProtect_693	Mycobacterium_avium	Mycobacterium	Positive_with_OM
AgProtect_692	Mycobacterium_tuberculosis	Mycobacterium	Positive_with_OM
AgProtect_691	Mycobacterium_tuberculosis	Mycobacterium	Positive_with_OM
AgProtect_690	Mycobacterium_tuberculosis	Mycobacterium	Positive_with_OM
AgProtect_69	Brucella_melitensis	Brucella	Negative
AgProtect_689	Neisseria_meningitidis	Neisseria	Negative
AgProtect_688	Neisseria_meningitidis	Neisseria	Negative
AgProtect_687	Neisseria_meningitidis	Neisseria	Negative
AgProtect_686	Neisseria_meningitidis	Neisseria	Negative
AgProtect_685	Neisseria_meningitidis	Neisseria	Negative
AgProtect_684	Pseudomonas_aeruginosa	Pseudomonas	Negative
AgProtect_683	Pseudomonas_aeruginosa	Pseudomonas	Negative
AgProtect_682	Salmonella_enterica_serovar_Typhimurium	Salmonella	Negative
AgProtect_681	Salmonella_enterica_serovar_Typhimurium	Salmonella	Negative
AgProtect_680	Staphylococcus_aureus	Staphylococcus	Positive
AgProtect_68	Neisseria_meningitidis	Neisseria	Negative
AgProtect_679	Staphylococcus_aureus	Staphylococcus	Positive
AgProtect_678	Staphylococcus_aureus	Staphylococcus	Positive
AgProtect_677	Staphylococcus_aureus	Staphylococcus	Positive
AgProtect_676	Staphylococcus_aureus	Staphylococcus	Positive
AgProtect_675	Staphylococcus_aureus	Staphylococcus	Positive
AgProtect_674	Staphylococcus_aureus	Staphylococcus	Positive
AgProtect_673	Staphylococcus_aureus	Staphylococcus	Positive
AgProtect_672	Streptococcus_agalactiae	Streptococcus	Positive
AgProtect_671	Streptococcus_agalactiae	Streptococcus	Positive
AgProtect_670	Streptococcus_agalactiae	Streptococcus	Positive
AgProtect_67	Neisseria_meningitidis	Neisseria	Negative
AgProtect_669	Streptococcus_agalactiae	Streptococcus	Positive
AgProtect_668	Staphylococcus_epidermidis	Staphylococcus	Positive
AgProtect_667	Streptococcus_pneumoniae	Streptococcus	Positive
AgProtect_666	Streptococcus_pneumoniae	Streptococcus	Positive
AgProtect_665	Streptococcus_pyogenes	Streptococcus	Positive
AgProtect_665	Streptococcus_pyogenes	Streptococcus	Positive
AgProtect_664	Streptococcus_pyogenes	Streptococcus	Positive
AgProtect_664	Streptococcus_pyogenes	Streptococcus	Positive
AgProtect_663	Streptococcus_pyogenes	Streptococcus	Positive
AgProtect_663	Streptococcus_pyogenes	Streptococcus	Positive
AgProtect_662	Streptococcus_pyogenes	Streptococcus	Positive
AgProtect_662	Streptococcus_pyogenes	Streptococcus	Positive
AgProtect_661	Streptococcus_pyogenes	Streptococcus	Positive
AgProtect_661	Streptococcus_pyogenes	Streptococcus	Positive
AgProtect_660	Yersinia_pestis	Yersinia	Negative
AgProtect_66	Escherichia_coli	Escherichia	Negative
AgProtect_659	Yersinia_pestis	Yersinia	Negative
AgProtect_658	Yersinia_pestis	Yersinia	Negative
AgProtect_657	Yersinia_pestis	Yersinia	Negative
AgProtect_656	Shigella_flexneri	Shigella	Negative
AgProtect_655	Shigella_flexneri	Shigella	Negative
AgProtect_654	Shigella_flexneri	Shigella	Negative
AgProtect_653	Shigella_flexneri	Shigella	Negative
AgProtect_652	Shigella_flexneri	Shigella	Negative
AgProtect_651	Shigella_flexneri	Shigella	Negative
AgProtect_650	Shigella_flexneri	Shigella	Negative
AgProtect_65	Escherichia_coli	Escherichia	Negative
AgProtect_649	Actinobacillus_pleuropneumoniae	Actinobacillus	Negative
AgProtect_648	Actinobacillus_pleuropneumoniae	Actinobacillus	Negative
AgProtect_647	Actinobacillus_pleuropneumoniae	Actinobacillus	Negative
AgProtect_646	Actinobacillus_pleuropneumoniae	Actinobacillus	Negative
AgProtect_645	Actinobacillus_pleuropneumoniae	Actinobacillus	Negative
AgProtect_644	Actinobacillus_pleuropneumoniae	Actinobacillus	Negative
AgProtect_643	Actinobacillus_pleuropneumoniae	Actinobacillus	Negative
AgProtect_642	Actinobacillus_pleuropneumoniae	Actinobacillus	Negative
AgProtect_641	Actinobacillus_pleuropneumoniae	Actinobacillus	Negative
AgProtect_640	Actinobacillus_pleuropneumoniae	Actinobacillus	Negative
AgProtect_64	Escherichia_coli	Escherichia	Negative
AgProtect_639	Actinobacillus_pleuropneumoniae	Actinobacillus	Negative
AgProtect_638	Actinobacillus_pleuropneumoniae	Actinobacillus	Negative
AgProtect_637	Actinobacillus_pleuropneumoniae	Actinobacillus	Negative
AgProtect_636	Actinobacillus_pleuropneumoniae	Actinobacillus	Negative
AgProtect_635	Actinobacillus_pleuropneumoniae	Actinobacillus	Negative
AgProtect_634	Actinobacillus_pleuropneumoniae	Actinobacillus	Negative
AgProtect_633	Chlamydia_muridarum	Chlamydia	Negative
AgProtect_632	Mycobacterium_tuberculosis	Mycobacterium	Positive_with_OM
AgProtect_631	Mycobacterium_tuberculosis	Mycobacterium	Positive_with_OM
AgProtect_630	Mycobacterium_tuberculosis	Mycobacterium	Positive_with_OM
AgProtect_63	Campylobacter_jejuni	Campylobacter	Negative
AgProtect_629	Mycobacterium_tuberculosis	Mycobacterium	Positive_with_OM
AgProtect_628	Escherichia_coli	Escherichia	Negative
AgProtect_627	Clostridium_botulinum	Clostridium	Positive
AgProtect_626	Clostridium_botulinum	Clostridium	Positive
AgProtect_625	Clostridium_botulinum	Clostridium	Positive
AgProtect_624	Clostridium_botulinum	Clostridium	Positive
AgProtect_623	Streptococcus_agalactiae	Streptococcus	Positive
AgProtect_622	Streptococcus_agalactiae	Streptococcus	Positive
AgProtect_621	Streptococcus_agalactiae	Streptococcus	Positive
AgProtect_620	Streptococcus_agalactiae	Streptococcus	Positive
AgProtect_62	Escherichia_coli	Escherichia	Negative
AgProtect_619	Streptococcus_agalactiae	Streptococcus	Positive
AgProtect_618	Streptococcus_agalactiae	Streptococcus	Positive
AgProtect_617	Streptococcus_agalactiae	Streptococcus	Positive
AgProtect_616	Streptococcus_agalactiae	Streptococcus	Positive
AgProtect_615	Streptococcus_agalactiae	Streptococcus	Positive
AgProtect_614	Streptococcus_agalactiae	Streptococcus	Positive
AgProtect_613	Streptococcus_agalactiae	Streptococcus	Positive
AgProtect_612	Streptococcus_agalactiae	Streptococcus	Positive
AgProtect_611	Streptococcus_agalactiae	Streptococcus	Positive
AgProtect_610	Streptococcus_agalactiae	Streptococcus	Positive
AgProtect_61	Pasteurella_multocida	Pasteurella	Negative
AgProtect_609	Streptococcus_agalactiae	Streptococcus	Positive
AgProtect_608	Streptococcus_agalactiae	Streptococcus	Positive
AgProtect_607	Streptococcus_agalactiae	Streptococcus	Positive
AgProtect_606	Streptococcus_agalactiae	Streptococcus	Positive
AgProtect_605	Streptococcus_equi	Streptococcus	Positive
AgProtect_604	Streptococcus_equi	Streptococcus	Positive
AgProtect_603	Streptococcus_equi	Streptococcus	Positive
AgProtect_602	Streptococcus_equi	Streptococcus	Positive
AgProtect_601	Streptococcus_equi	Streptococcus	Positive
AgProtect_600	Streptococcus_equi	Streptococcus	Positive
AgProtect_60	Staphylococcus_aureus	Staphylococcus	Positive
AgProtect_6	Yersinia_pestis	Yersinia	Negative
AgProtect_599	Streptococcus_equi	Streptococcus	Positive
AgProtect_598	Streptococcus_equi	Streptococcus	Positive
AgProtect_597	Streptococcus_equi	Streptococcus	Positive
AgProtect_596	Streptococcus_equi	Streptococcus	Positive
AgProtect_595	Streptococcus_equi	Streptococcus	Positive
AgProtect_594	Staphylococcus_aureus	Staphylococcus	Positive
AgProtect_593	Staphylococcus_aureus	Staphylococcus	Positive
AgProtect_592	Staphylococcus_aureus	Staphylococcus	Positive
AgProtect_591	Staphylococcus_aureus	Staphylococcus	Positive
AgProtect_590	Staphylococcus_aureus	Staphylococcus	Positive
AgProtect_59	Campylobacter_jejuni	Campylobacter	Negative
AgProtect_589	Staphylococcus_aureus	Staphylococcus	Positive
AgProtect_588	Staphylococcus_aureus	Staphylococcus	Positive
AgProtect_587	Staphylococcus_aureus	Staphylococcus	Positive
AgProtect_586	Staphylococcus_aureus	Staphylococcus	Positive
AgProtect_585	Staphylococcus_aureus	Staphylococcus	Positive
AgProtect_584	Mycobacterium_tuberculosis	Mycobacterium	Positive_with_OM
AgProtect_583	Staphylococcus_aureus	Staphylococcus	Positive
AgProtect_582	Staphylococcus_aureus	Staphylococcus	Positive
AgProtect_581	Staphylococcus_aureus	Staphylococcus	Positive
AgProtect_580	Staphylococcus_aureus	Staphylococcus	Positive
AgProtect_58	Chlamydia_muridarum	Chlamydia	Negative
AgProtect_579	Staphylococcus_aureus	Staphylococcus	Positive
AgProtect_578	Staphylococcus_aureus	Staphylococcus	Positive
AgProtect_577	Staphylococcus_aureus	Staphylococcus	Positive
AgProtect_576	Staphylococcus_aureus	Staphylococcus	Positive
AgProtect_575	Staphylococcus_aureus	Staphylococcus	Positive
AgProtect_574	Staphylococcus_aureus	Staphylococcus	Positive
AgProtect_573	Staphylococcus_aureus	Staphylococcus	Positive
AgProtect_572	Streptococcus_pneumoniae	Streptococcus	Positive
AgProtect_571	Streptococcus_pneumoniae	Streptococcus	Positive
AgProtect_570	Streptococcus_pneumoniae	Streptococcus	Positive
AgProtect_57	Streptococcus_equi	Streptococcus	Positive
AgProtect_569	Streptococcus_pneumoniae	Streptococcus	Positive
AgProtect_568	Streptococcus_pneumoniae	Streptococcus	Positive
AgProtect_567	Streptococcus_pseudopneumoniae	Streptococcus	Positive
AgProtect_566	Streptococcus_pneumoniae	Streptococcus	Positive
AgProtect_565	Streptococcus_pneumoniae	Streptococcus	Positive
AgProtect_564	Streptococcus_pneumoniae	Streptococcus	Positive
AgProtect_563	Streptococcus_pneumoniae	Streptococcus	Positive
AgProtect_562	Streptococcus_pneumoniae	Streptococcus	Positive
AgProtect_561	Streptococcus_pyogenes	Streptococcus	Positive
AgProtect_561	Streptococcus_pyogenes	Streptococcus	Positive
AgProtect_560	Streptococcus_pyogenes	Streptococcus	Positive
AgProtect_560	Streptococcus_pyogenes	Streptococcus	Positive
AgProtect_56	Streptococcus_agalactiae	Streptococcus	Positive
AgProtect_559	Streptococcus_pyogenes	Streptococcus	Positive
AgProtect_559	Streptococcus_pyogenes	Streptococcus	Positive
AgProtect_558	Streptococcus_pyogenes	Streptococcus	Positive
AgProtect_558	Streptococcus_pyogenes	Streptococcus	Positive
AgProtect_557	Streptococcus_pyogenes	Streptococcus	Positive
AgProtect_557	Streptococcus_pyogenes	Streptococcus	Positive
AgProtect_556	Streptococcus_pyogenes	Streptococcus	Positive
AgProtect_556	Streptococcus_pyogenes	Streptococcus	Positive
AgProtect_555	Streptococcus_pyogenes	Streptococcus	Positive
AgProtect_555	Streptococcus_pyogenes	Streptococcus	Positive
AgProtect_554	Streptococcus_pyogenes	Streptococcus	Positive
AgProtect_554	Streptococcus_pyogenes	Streptococcus	Positive
AgProtect_553	Streptococcus_pyogenes	Streptococcus	Positive
AgProtect_553	Streptococcus_pyogenes	Streptococcus	Positive
AgProtect_552	Streptococcus_pyogenes	Streptococcus	Positive
AgProtect_552	Streptococcus_pyogenes	Streptococcus	Positive
AgProtect_551	Streptococcus_pyogenes	Streptococcus	Positive
AgProtect_551	Streptococcus_pyogenes	Streptococcus	Positive
AgProtect_550	Streptococcus_pyogenes	Streptococcus	Positive
AgProtect_550	Streptococcus_pyogenes	Streptococcus	Positive
AgProtect_55	Escherichia_coli	Escherichia	Negative
AgProtect_549	Streptococcus_pyogenes	Streptococcus	Positive
AgProtect_549	Streptococcus_pyogenes	Streptococcus	Positive
AgProtect_548	Streptococcus_pyogenes	Streptococcus	Positive
AgProtect_548	Streptococcus_pyogenes	Streptococcus	Positive
AgProtect_547	Streptococcus_pyogenes	Streptococcus	Positive
AgProtect_547	Streptococcus_pyogenes	Streptococcus	Positive
AgProtect_546	Streptococcus_pyogenes	Streptococcus	Positive
AgProtect_546	Streptococcus_pyogenes	Streptococcus	Positive
AgProtect_545	Streptococcus_pyogenes	Streptococcus	Positive
AgProtect_545	Streptococcus_pyogenes	Streptococcus	Positive
AgProtect_544	Streptococcus_pyogenes	Streptococcus	Positive
AgProtect_544	Streptococcus_pyogenes	Streptococcus	Positive
AgProtect_543	Streptococcus_pyogenes	Streptococcus	Positive
AgProtect_543	Streptococcus_pyogenes	Streptococcus	Positive
AgProtect_542	Streptococcus_pyogenes	Streptococcus	Positive
AgProtect_542	Streptococcus_pyogenes	Streptococcus	Positive
AgProtect_541	Streptococcus_pyogenes	Streptococcus	Positive
AgProtect_541	Streptococcus_pyogenes	Streptococcus	Positive
AgProtect_540	Streptococcus_pyogenes	Streptococcus	Positive
AgProtect_540	Streptococcus_pyogenes	Streptococcus	Positive
AgProtect_54	Shigella_flexneri	Shigella	Negative
AgProtect_539	Streptococcus_pyogenes	Streptococcus	Positive
AgProtect_539	Streptococcus_pyogenes	Streptococcus	Positive
AgProtect_538	Streptococcus_pyogenes	Streptococcus	Positive
AgProtect_538	Streptococcus_pyogenes	Streptococcus	Positive
AgProtect_537	Streptococcus_pyogenes	Streptococcus	Positive
AgProtect_537	Streptococcus_pyogenes	Streptococcus	Positive
AgProtect_536	Streptococcus_pyogenes	Streptococcus	Positive
AgProtect_536	Streptococcus_pyogenes	Streptococcus	Positive
AgProtect_535	Streptococcus_pyogenes	Streptococcus	Positive
AgProtect_535	Streptococcus_pyogenes	Streptococcus	Positive
AgProtect_534	Streptococcus_pyogenes	Streptococcus	Positive
AgProtect_534	Streptococcus_pyogenes	Streptococcus	Positive
AgProtect_533	Streptococcus_pneumoniae	Streptococcus	Positive
AgProtect_532	Streptococcus_pyogenes	Streptococcus	Positive
AgProtect_532	Streptococcus_pyogenes	Streptococcus	Positive
AgProtect_531	Streptococcus_pyogenes	Streptococcus	Positive
AgProtect_531	Streptococcus_pyogenes	Streptococcus	Positive
AgProtect_530	Streptococcus_pneumoniae	Streptococcus	Positive
AgProtect_53	Brucella_abortus	Brucella	Negative
AgProtect_529	Streptococcus_pneumoniae	Streptococcus	Positive
AgProtect_528	Streptococcus_pneumoniae	Streptococcus	Positive
AgProtect_527	Streptococcus_pyogenes	Streptococcus	Positive
AgProtect_527	Streptococcus_pyogenes	Streptococcus	Positive
AgProtect_526	Streptococcus_pyogenes	Streptococcus	Positive
AgProtect_526	Streptococcus_pyogenes	Streptococcus	Positive
AgProtect_525	Streptococcus_pyogenes	Streptococcus	Positive
AgProtect_525	Streptococcus_pyogenes	Streptococcus	Positive
AgProtect_524	Streptococcus_pyogenes	Streptococcus	Positive
AgProtect_524	Streptococcus_pyogenes	Streptococcus	Positive
AgProtect_523	Streptococcus_pyogenes	Streptococcus	Positive
AgProtect_523	Streptococcus_pyogenes	Streptococcus	Positive
AgProtect_522	Streptococcus_pyogenes	Streptococcus	Positive
AgProtect_522	Streptococcus_pyogenes	Streptococcus	Positive
AgProtect_521	Streptococcus_pyogenes	Streptococcus	Positive
AgProtect_521	Streptococcus_pyogenes	Streptococcus	Positive
AgProtect_520	Streptococcus_pyogenes	Streptococcus	Positive
AgProtect_520	Streptococcus_pyogenes	Streptococcus	Positive
AgProtect_52	Escherichia_coli	Escherichia	Negative
AgProtect_519	Streptococcus_pyogenes	Streptococcus	Positive
AgProtect_519	Streptococcus_pyogenes	Streptococcus	Positive
AgProtect_518	Actinobacillus_pleuropneumoniae	Actinobacillus	Negative
AgProtect_517	Actinobacillus_pleuropneumoniae	Actinobacillus	Negative
AgProtect_516	Actinobacillus_pleuropneumoniae	Actinobacillus	Negative
AgProtect_515	Actinobacillus_pleuropneumoniae	Actinobacillus	Negative
AgProtect_514	Actinobacillus_pleuropneumoniae	Actinobacillus	Negative
AgProtect_513	Actinobacillus_pleuropneumoniae	Actinobacillus	Negative
AgProtect_512	Actinobacillus_pleuropneumoniae	Actinobacillus	Negative
AgProtect_511	Actinobacillus_pleuropneumoniae	Actinobacillus	Negative
AgProtect_510	Actinobacillus_pleuropneumoniae	Actinobacillus	Negative
AgProtect_51	Coxiella_burnetii	Coxiella	Negative
AgProtect_509	Actinobacillus_pleuropneumoniae	Actinobacillus	Negative
AgProtect_508	Actinobacillus_pleuropneumoniae	Actinobacillus	Negative
AgProtect_507	Actinobacillus_pleuropneumoniae	Actinobacillus	Negative
AgProtect_506	Actinobacillus_pleuropneumoniae	Actinobacillus	Negative
AgProtect_505	Actinobacillus_pleuropneumoniae	Actinobacillus	Negative
AgProtect_504	Actinobacillus_pleuropneumoniae	Actinobacillus	Negative
AgProtect_503	Aeromonas_salmonicida	Aeromonas	Negative
AgProtect_502	Borreliella_burgdorferi	Borreliella	Negative
AgProtect_501	Borreliella_burgdorferi	Borreliella	Negative
AgProtect_500	Borreliella_burgdorferi	Borreliella	Negative
AgProtect_50	Coxiella_burnetii	Coxiella	Negative
AgProtect_5	Bacillus_anthracis	Bacillus	Positive
AgProtect_499	Borreliella_burgdorferi	Borreliella	Negative
AgProtect_498	Borreliella_burgdorferi	Borreliella	Negative
AgProtect_497	Borreliella_burgdorferi	Borreliella	Negative
AgProtect_496	Burkholderia_pseudomallei	Burkholderia	Negative
AgProtect_495	Burkholderia_pseudomallei	Burkholderia	Negative
AgProtect_494	Burkholderia_pseudomallei	Burkholderia	Negative
AgProtect_493	Burkholderia_pseudomallei	Burkholderia	Negative
AgProtect_492	Burkholderia_pseudomallei	Burkholderia	Negative
AgProtect_491	Burkholderia_pseudomallei	Burkholderia	Negative
AgProtect_490	Burkholderia_pseudomallei	Burkholderia	Negative
AgProtect_49	Brucella_abortus	Brucella	Negative
AgProtect_489	Burkholderia_pseudomallei	Burkholderia	Negative
AgProtect_488	Burkholderia_pseudomallei	Burkholderia	Negative
AgProtect_487	Burkholderia_pseudomallei	Burkholderia	Negative
AgProtect_486	Campylobacter_jejuni	Campylobacter	Negative
AgProtect_485	Campylobacter_jejuni	Campylobacter	Negative
AgProtect_484	Campylobacter_jejuni	Campylobacter	Negative
AgProtect_483	Campylobacter_jejuni	Campylobacter	Negative
AgProtect_482	Campylobacter_jejuni	Campylobacter	Negative
AgProtect_481	Campylobacter_jejuni	Campylobacter	Negative
AgProtect_480	Campylobacter_jejuni	Campylobacter	Negative
AgProtect_48	Chlamydia_psittaci	Chlamydia	Negative
AgProtect_479	Campylobacter_jejuni	Campylobacter	Negative
AgProtect_478	Campylobacter_jejuni	Campylobacter	Negative
AgProtect_477	Chlamydia_trachomatis	Chlamydia	Negative
AgProtect_476	Chlamydia_trachomatis	Chlamydia	Negative
AgProtect_475	Chlamydia_trachomatis	Chlamydia	Negative
AgProtect_474	Chlamydia_muridarum	Chlamydia	Negative
AgProtect_473	Chlamydia_trachomatis	Chlamydia	Negative
AgProtect_472	Chlamydia_trachomatis	Chlamydia	Negative
AgProtect_471	Chlamydia_muridarum	Chlamydia	Negative
AgProtect_470	Chlamydia_muridarum	Chlamydia	Negative
AgProtect_47	Chlamydia_psittaci	Chlamydia	Negative
AgProtect_469	Chlamydia_muridarum	Chlamydia	Negative
AgProtect_468	Chlamydia_muridarum	Chlamydia	Negative
AgProtect_467	Chlamydia_muridarum	Chlamydia	Negative
AgProtect_466	Chlamydia_trachomatis	Chlamydia	Negative
AgProtect_465	Chlamydia_trachomatis	Chlamydia	Negative
AgProtect_464	Chlamydia_trachomatis	Chlamydia	Negative
AgProtect_463	Chlamydia_trachomatis	Chlamydia	Negative
AgProtect_462	Chlamydia_trachomatis	Chlamydia	Negative
AgProtect_461	Chlamydia_trachomatis	Chlamydia	Negative
AgProtect_460	Chlamydia_trachomatis	Chlamydia	Negative
AgProtect_46	Burkholderia_pseudomallei	Burkholderia	Negative
AgProtect_459	Chlamydia_pneumoniae	Chlamydia	Negative
AgProtect_458	Chlamydia_abortus	Chlamydia	Negative
AgProtect_457	Chlamydia_pneumoniae	Chlamydia	Negative
AgProtect_456	Chlamydia_pneumoniae	Chlamydia	Negative
AgProtect_455	Chlamydia_pneumoniae	Chlamydia	Negative
AgProtect_454	Chlamydia_pneumoniae	Chlamydia	Negative
AgProtect_453	Chlamydia_pneumoniae	Chlamydia	Negative
AgProtect_452	Chlamydia_pneumoniae	Chlamydia	Negative
AgProtect_451	Chlamydia_psittaci	Chlamydia	Negative
AgProtect_450	Coxiella_burnetii	Coxiella	Negative
AgProtect_45	Burkholderia_pseudomallei	Burkholderia	Negative
AgProtect_449	Coxiella_burnetii	Coxiella	Negative
AgProtect_448	Coxiella_burnetii	Coxiella	Negative
AgProtect_447	Coxiella_burnetii	Coxiella	Negative
AgProtect_446	Coxiella_burnetii	Coxiella	Negative
AgProtect_445	Coxiella_burnetii	Coxiella	Negative
AgProtect_444	Coxiella_burnetii	Coxiella	Negative
AgProtect_443	Coxiella_burnetii	Coxiella	Negative
AgProtect_442	Coxiella_burnetii	Coxiella	Negative
AgProtect_441	Rickettsia_rickettsii	Rickettsia	Negative
AgProtect_440	Edwardsiella_tarda	Edwardsiella	Negative
AgProtect_44	Mycobacterium_tuberculosis	Mycobacterium	Positive_with_OM
AgProtect_439	Edwardsiella_tarda	Edwardsiella	Negative
AgProtect_438	Edwardsiella_tarda	Edwardsiella	Negative
AgProtect_437	Edwardsiella_tarda	Edwardsiella	Negative
AgProtect_436	Edwardsiella_tarda	Edwardsiella	Negative
AgProtect_435	Edwardsiella_tarda	Edwardsiella	Negative
AgProtect_434	Edwardsiella_tarda	Edwardsiella	Negative
AgProtect_433	Edwardsiella_tarda	Edwardsiella	Negative
AgProtect_432	Edwardsiella_tarda	Edwardsiella	Negative
AgProtect_431	Edwardsiella_tarda	Edwardsiella	Negative
AgProtect_430	Edwardsiella_tarda	Edwardsiella	Negative
AgProtect_43	Haemophilus_influenzae	Haemophilus	Negative
AgProtect_429	Edwardsiella_tarda	Edwardsiella	Negative
AgProtect_428	Edwardsiella_tarda	Edwardsiella	Negative
AgProtect_427	Edwardsiella_tarda	Edwardsiella	Negative
AgProtect_426	Edwardsiella_tarda	Edwardsiella	Negative
AgProtect_425	Edwardsiella_tarda	Edwardsiella	Negative
AgProtect_424	Edwardsiella_tarda	Edwardsiella	Negative
AgProtect_423	Edwardsiella_tarda	Edwardsiella	Negative
AgProtect_422	Escherichia_coli	Escherichia	Negative
AgProtect_421	Escherichia_coli	Escherichia	Negative
AgProtect_420	Escherichia_coli	Escherichia	Negative
AgProtect_42	Haemophilus_influenzae	Haemophilus	Negative
AgProtect_419	Escherichia_coli	Escherichia	Negative
AgProtect_418	Escherichia_coli	Escherichia	Negative
AgProtect_417	Escherichia_coli	Escherichia	Negative
AgProtect_416	Escherichia_coli	Escherichia	Negative
AgProtect_415	Escherichia_coli	Escherichia	Negative
AgProtect_414	Escherichia_coli	Escherichia	Negative
AgProtect_413	Escherichia_coli	Escherichia	Negative
AgProtect_412	Mycobacterium_tuberculosis	Mycobacterium	Positive_with_OM
AgProtect_411	Escherichia_coli	Escherichia	Negative
AgProtect_410	Escherichia_coli	Escherichia	Negative
AgProtect_41	Haemophilus_influenzae	Haemophilus	Negative
AgProtect_409	Escherichia_coli	Escherichia	Negative
AgProtect_408	Escherichia_coli	Escherichia	Negative
AgProtect_407	Escherichia_coli	Escherichia	Negative
AgProtect_406	Escherichia_coli	Escherichia	Negative
AgProtect_405	Escherichia_coli	Escherichia	Negative
AgProtect_404	Escherichia_coli	Escherichia	Negative
AgProtect_403	Escherichia_coli	Escherichia	Negative
AgProtect_402	Escherichia_coli	Escherichia	Negative
AgProtect_401	Escherichia_coli	Escherichia	Negative
AgProtect_400	Escherichia_coli	Escherichia	Negative
AgProtect_40	Haemophilus_influenzae	Haemophilus	Negative
AgProtect_4	Yersinia_pestis	Yersinia	Negative
AgProtect_399	Escherichia_coli	Escherichia	Negative
AgProtect_398	Escherichia_coli	Escherichia	Negative
AgProtect_397	Escherichia_coli	Escherichia	Negative
AgProtect_396	Escherichia_coli	Escherichia	Negative
AgProtect_395	Escherichia_coli	Escherichia	Negative
AgProtect_394	Escherichia_coli	Escherichia	Negative
AgProtect_393	Francisella_tularensis	Francisella	Negative
AgProtect_392	Francisella_tularensis	Francisella	Negative
AgProtect_391	Francisella_tularensis	Francisella	Negative
AgProtect_390	Haemophilus_influenzae	Haemophilus	Negative
AgProtect_39	Yersinia_pestis	Yersinia	Negative
AgProtect_389	Haemophilus_influenzae	Haemophilus	Negative
AgProtect_388	Haemophilus_influenzae	Haemophilus	Negative
AgProtect_387	Glaesserella_parasuis	Glaesserella	Negative
AgProtect_386	Glaesserella_parasuis	Glaesserella	Negative
AgProtect_385	Glaesserella_parasuis	Glaesserella	Negative
AgProtect_384	Glaesserella_parasuis	Glaesserella	Negative
AgProtect_383	Glaesserella_parasuis	Glaesserella	Negative
AgProtect_382	Glaesserella_parasuis	Glaesserella	Negative
AgProtect_381	Glaesserella_parasuis	Glaesserella	Negative
AgProtect_380	Glaesserella_parasuis	Glaesserella	Negative
AgProtect_38	Pseudomonas_aeruginosa	Pseudomonas	Negative
AgProtect_379	Glaesserella_parasuis	Glaesserella	Negative
AgProtect_378	Glaesserella_parasuis	Glaesserella	Negative
AgProtect_377	Glaesserella_parasuis	Glaesserella	Negative
AgProtect_376	Glaesserella_parasuis	Glaesserella	Negative
AgProtect_375	Glaesserella_parasuis	Glaesserella	Negative
AgProtect_374	Glaesserella_parasuis	Glaesserella	Negative
AgProtect_373	Glaesserella_parasuis	Glaesserella	Negative
AgProtect_372	Glaesserella_parasuis	Glaesserella	Negative
AgProtect_371	Glaesserella_parasuis	Glaesserella	Negative
AgProtect_370	Glaesserella_parasuis	Glaesserella	Negative
AgProtect_37	Pseudomonas_aeruginosa	Pseudomonas	Negative
AgProtect_369	Glaesserella_parasuis	Glaesserella	Negative
AgProtect_368	Glaesserella_parasuis	Glaesserella	Negative
AgProtect_367	Glaesserella_parasuis	Glaesserella	Negative
AgProtect_366	Glaesserella_parasuis	Glaesserella	Negative
AgProtect_365	Glaesserella_parasuis	Glaesserella	Negative
AgProtect_364	Glaesserella_parasuis	Glaesserella	Negative
AgProtect_363	Glaesserella_parasuis	Glaesserella	Negative
AgProtect_362	Glaesserella_parasuis	Glaesserella	Negative
AgProtect_361	Glaesserella_parasuis	Glaesserella	Negative
AgProtect_360	Helicobacter_pylori	Helicobacter	Negative
AgProtect_36	Pseudomonas_aeruginosa	Pseudomonas	Negative
AgProtect_359	Helicobacter_pylori	Helicobacter	Negative
AgProtect_358	Helicobacter_pylori	Helicobacter	Negative
AgProtect_357	Helicobacter_pylori	Helicobacter	Negative
AgProtect_356	Helicobacter_pylori	Helicobacter	Negative
AgProtect_355	Helicobacter_pylori	Helicobacter	Negative
AgProtect_354	Helicobacter_pylori	Helicobacter	Negative
AgProtect_353	Helicobacter_pylori	Helicobacter	Negative
AgProtect_352	Helicobacter_pylori	Helicobacter	Negative
AgProtect_351	Helicobacter_pylori	Helicobacter	Negative
AgProtect_350	Helicobacter_pylori	Helicobacter	Negative
AgProtect_35	Clostridium_tetani	Clostridium	Positive
AgProtect_349	Helicobacter_pylori	Helicobacter	Negative
AgProtect_348	Helicobacter_pylori	Helicobacter	Negative
AgProtect_347	Leptospira_interrogans	Leptospira	Negative
AgProtect_346	Leptospira_interrogans	Leptospira	Negative
AgProtect_345	Leptospira_interrogans	Leptospira	Negative
AgProtect_344	Leptospira_interrogans	Leptospira	Negative
AgProtect_343	Leptospira_interrogans	Leptospira	Negative
AgProtect_342	Leptospira_interrogans	Leptospira	Negative
AgProtect_341	Leptospira_interrogans	Leptospira	Negative
AgProtect_340	Leptospira_interrogans	Leptospira	Negative
AgProtect_34	Brucella_abortus	Brucella	Negative
AgProtect_339	Leptospira_interrogans	Leptospira	Negative
AgProtect_338	Mycoplasma_gallisepticum	Mycoplasma	Negative_without_OM
AgProtect_337	Bacillus_anthracis	Bacillus	Positive
AgProtect_336	Bacillus_anthracis	Bacillus	Positive
AgProtect_335	Bacillus_anthracis	Bacillus	Positive
AgProtect_334	Mycobacterium_tuberculosis	Mycobacterium	Positive_with_OM
AgProtect_333	Bacillus_anthracis	Bacillus	Positive
AgProtect_332	Pseudomonas_aeruginosa	Pseudomonas	Negative
AgProtect_331	Pseudomonas_aeruginosa	Pseudomonas	Negative
AgProtect_330	Pseudomonas_aeruginosa	Pseudomonas	Negative
AgProtect_33	Brucella_abortus	Brucella	Negative
AgProtect_329	Pseudomonas_aeruginosa	Pseudomonas	Negative
AgProtect_328	Pseudomonas_aeruginosa	Pseudomonas	Negative
AgProtect_327	Pseudomonas_aeruginosa	Pseudomonas	Negative
AgProtect_326	Pseudomonas_aeruginosa	Pseudomonas	Negative
AgProtect_325	Pseudomonas_aeruginosa	Pseudomonas	Negative
AgProtect_324	Pseudomonas_aeruginosa	Pseudomonas	Negative
AgProtect_323	Pseudomonas_aeruginosa	Pseudomonas	Negative
AgProtect_322	Pseudomonas_aeruginosa	Pseudomonas	Negative
AgProtect_321	Rickettsia_typhi	Rickettsia	Negative
AgProtect_320	Rickettsia_rickettsii	Rickettsia	Negative
AgProtect_32	Clostridium_tetani	Clostridium	Positive
AgProtect_319	Rickettsia_conorii	Rickettsia	Negative
AgProtect_318	Rickettsia_prowazekii	Rickettsia	Negative
AgProtect_317	Rickettsia_prowazekii	Rickettsia	Negative
AgProtect_316	Rickettsia_rickettsii	Rickettsia	Negative
AgProtect_315	Rickettsia_prowazekii	Rickettsia	Negative
AgProtect_314	Rickettsia_prowazekii	Rickettsia	Negative
AgProtect_313	Rickettsia_prowazekii	Rickettsia	Negative
AgProtect_312	Rickettsia_prowazekii	Rickettsia	Negative
AgProtect_311	Mycobacterium_tuberculosis	Mycobacterium	Positive_with_OM
AgProtect_310	Shigella_dysenteriae	Shigella	Negative
AgProtect_31	Clostridium_botulinum	Clostridium	Positive
AgProtect_309	Shigella_dysenteriae	Shigella	Negative
AgProtect_308	Shigella_flexneri	Shigella	Negative
AgProtect_307	Shigella_sonnei	Shigella	Negative
AgProtect_306	Shigella_flexneri	Shigella	Negative
AgProtect_305	Shigella_flexneri	Shigella	Negative
AgProtect_304	Porphyromonas_gingivalis	Porphyromonas	Negative
AgProtect_303	Treponema_pallidum	Treponema	Negative
AgProtect_302	Treponema_pallidum	Treponema	Negative
AgProtect_301	Treponema_pallidum	Treponema	Negative
AgProtect_300	Treponema_pallidum	Treponema	Negative
AgProtect_30	Clostridium_botulinum	Clostridium	Positive
AgProtect_3	Haemophilus_influenzae	Haemophilus	Negative
AgProtect_299	Treponema_pallidum	Treponema	Negative
AgProtect_298	Treponema_pallidum	Treponema	Negative
AgProtect_297	Treponema_pallidum	Treponema	Negative
AgProtect_296	Treponema_pallidum	Treponema	Negative
AgProtect_295	Treponema_pallidum	Treponema	Negative
AgProtect_294	Treponema_pallidum	Treponema	Negative
AgProtect_293	Treponema_pallidum	Treponema	Negative
AgProtect_292	Treponema_pallidum	Treponema	Negative
AgProtect_291	Vibrio_vulnificus	Vibrio	Negative
AgProtect_290	Vibrio_cholerae	Vibrio	Negative
AgProtect_29	Borreliella_burgdorferi	Borreliella	Negative
AgProtect_289	Vibrio_cholerae	Vibrio	Negative
AgProtect_288	Vibrio_cholerae	Vibrio	Negative
AgProtect_287	Yersinia_pseudotuberculosis	Yersinia	Negative
AgProtect_286	Yersinia_pseudotuberculosis	Yersinia	Negative
AgProtect_285	Mycobacterium_tuberculosis	Mycobacterium	Positive_with_OM
AgProtect_284	Mycobacterium_tuberculosis	Mycobacterium	Positive_with_OM
AgProtect_283	Staphylococcus_aureus	Staphylococcus	Positive
AgProtect_282	Leptospira_interrogans	Leptospira	Negative
AgProtect_281	Helicobacter_pylori	Helicobacter	Negative
AgProtect_280	Edwardsiella_tarda	Edwardsiella	Negative
AgProtect_28	Mycobacterium_intracellulare	Mycobacterium	Positive_with_OM
AgProtect_279	Edwardsiella_tarda	Edwardsiella	Negative
AgProtect_278	Edwardsiella_tarda	Edwardsiella	Negative
AgProtect_277	Edwardsiella_tarda	Edwardsiella	Negative
AgProtect_276	Chlamydia_trachomatis	Chlamydia	Negative
AgProtect_275	Chlamydia_pneumoniae	Chlamydia	Negative
AgProtect_274	Brucella_abortus	Brucella	Negative
AgProtect_273	Pseudomonas_aeruginosa	Pseudomonas	Negative
AgProtect_272	Leptospira_interrogans	Leptospira	Negative
AgProtect_271	Leptospira_interrogans	Leptospira	Negative
AgProtect_270	Brucella_abortus	Brucella	Negative
AgProtect_27	Clostridium_botulinum	Clostridium	Positive
AgProtect_269	Actinobacillus_pleuropneumoniae	Actinobacillus	Negative
AgProtect_268	Bacillus_anthracis	Bacillus	Positive
AgProtect_267	Erysipelothrix_rhusiopathiae	Erysipelothrix	Positive
AgProtect_266	Pasteurella_multocida	Pasteurella	Negative
AgProtect_265	Pasteurella_multocida	Pasteurella	Negative
AgProtect_264	Glaesserella_parasuis	Glaesserella	Negative
AgProtect_263	Brucella_melitensis	Brucella	Negative
AgProtect_262	Mycobacterium_marinum	Mycobacterium	Positive_with_OM
AgProtect_261	Borreliella_burgdorferi	Borreliella	Negative
AgProtect_260	Mycobacterium_leprae	Mycobacterium	Positive_with_OM
AgProtect_26	Chlamydia_pneumoniae	Chlamydia	Negative
AgProtect_259	Mycobacterium_leprae	Mycobacterium	Positive_with_OM
AgProtect_258	Streptococcus_pyogenes	Streptococcus	Positive
AgProtect_258	Streptococcus_pyogenes	Streptococcus	Positive
AgProtect_257	Streptococcus_pyogenes	Streptococcus	Positive
AgProtect_257	Streptococcus_pyogenes	Streptococcus	Positive
AgProtect_256	Mycobacterium_tuberculosis	Mycobacterium	Positive_with_OM
AgProtect_255	Salmonella_enterica_serovar_Typhimurium	Salmonella	Negative
AgProtect_254	Brucella_abortus	Brucella	Negative
AgProtect_253	Brucella_abortus	Brucella	Negative
AgProtect_252	Brucella_melitensis	Brucella	Negative
AgProtect_251	Yersinia_pestis	Yersinia	Negative
AgProtect_250	Mycobacterium_tuberculosis	Mycobacterium	Positive_with_OM
AgProtect_25	Chlamydia_pneumoniae	Chlamydia	Negative
AgProtect_249	Mesomycoplasma_hyopneumoniae	Mesomycoplasma	Negative_without_OM
AgProtect_248	Mycobacterium_tuberculosis	Mycobacterium	Positive_with_OM
AgProtect_247	Mycobacterium_tuberculosis	Mycobacterium	Positive_with_OM
AgProtect_246	Mycobacterium_tuberculosis	Mycobacterium	Positive_with_OM
AgProtect_245	Haemophilus_influenzae	Haemophilus	Negative
AgProtect_244	Haemophilus_influenzae	Haemophilus	Negative
AgProtect_243	Listeria_monocytogenes	Listeria	Positive
AgProtect_242	Streptococcus_agalactiae	Streptococcus	Positive
AgProtect_241	Streptococcus_agalactiae	Streptococcus	Positive
AgProtect_240	Treponema_pallidum	Treponema	Negative
AgProtect_24	Chlamydia_pneumoniae	Chlamydia	Negative
AgProtect_239	Treponema_pallidum	Treponema	Negative
AgProtect_238	Treponema_pallidum	Treponema	Negative
AgProtect_237	Streptococcus_pyogenes	Streptococcus	Positive
AgProtect_237	Streptococcus_pyogenes	Streptococcus	Positive
AgProtect_236	Streptococcus_pyogenes	Streptococcus	Positive
AgProtect_236	Streptococcus_pyogenes	Streptococcus	Positive
AgProtect_235	Streptococcus_pyogenes	Streptococcus	Positive
AgProtect_235	Streptococcus_pyogenes	Streptococcus	Positive
AgProtect_234	Streptococcus_pyogenes	Streptococcus	Positive
AgProtect_234	Streptococcus_pyogenes	Streptococcus	Positive
AgProtect_233	Streptococcus_agalactiae	Streptococcus	Positive
AgProtect_232	Staphylococcus_aureus	Staphylococcus	Positive
AgProtect_231	Staphylococcus_aureus	Staphylococcus	Positive
AgProtect_230	Staphylococcus_aureus	Staphylococcus	Positive
AgProtect_23	Chlamydia_muridarum	Chlamydia	Negative
AgProtect_229	Staphylococcus_aureus	Staphylococcus	Positive
AgProtect_2283	Neisseria_meningitidis	Neisseria	Negative
AgProtect_2282	Chlamydia_trachomatis	Chlamydia	Negative
AgProtect_2281	Chlamydia_trachomatis	Chlamydia	Negative
AgProtect_2280	Escherichia_coli	Escherichia	Negative
AgProtect_228	Listeria_monocytogenes	Listeria	Positive
AgProtect_2279	Mycobacterium_tuberculosis	Mycobacterium	Positive_with_OM
AgProtect_2278	Mycobacterium_tuberculosis	Mycobacterium	Positive_with_OM
AgProtect_2277	Mycobacterium_tuberculosis	Mycobacterium	Positive_with_OM
AgProtect_2276	Escherichia_coli	Escherichia	Negative
AgProtect_2275	Mycobacterium_tuberculosis	Mycobacterium	Positive_with_OM
AgProtect_2274	Mycobacterium_tuberculosis	Mycobacterium	Positive_with_OM
AgProtect_2273	Salmonella_enterica_serovar_Typhimurium	Salmonella	Negative
AgProtect_2272	Mycobacterium_tuberculosis	Mycobacterium	Positive_with_OM
AgProtect_2271	Streptococcus_pneumoniae	Streptococcus	Positive
AgProtect_2270	Mycobacterium_tuberculosis	Mycobacterium	Positive_with_OM
AgProtect_227	Borreliella_burgdorferi	Borreliella	Negative
AgProtect_2269	Bacillus_anthracis	Bacillus	Positive
AgProtect_2268	Leptospira_interrogans	Leptospira	Negative
AgProtect_2267	Treponema_pallidum	Treponema	Negative
AgProtect_2266	Coxiella_burnetii	Coxiella	Negative
AgProtect_2265	Glaesserella_parasuis	Glaesserella	Negative
AgProtect_2264	Streptococcus_pneumoniae	Streptococcus	Positive
AgProtect_2263	Rickettsia_tamurae	Rickettsia	Negative
AgProtect_2262	Streptococcus_pneumoniae	Streptococcus	Positive
AgProtect_2261	Mycobacterium_leprae	Mycobacterium	Positive_with_OM
AgProtect_2260	Helicobacter_pylori	Helicobacter	Negative
AgProtect_226	Borreliella_burgdorferi	Borreliella	Negative
AgProtect_2259	Escherichia_coli	Escherichia	Negative
AgProtect_2258	Coxiella_burnetii	Coxiella	Negative
AgProtect_2257	Pseudomonas_aeruginosa	Pseudomonas	Negative
AgProtect_2256	Helicobacter_pylori	Helicobacter	Negative
AgProtect_2255	Campylobacter_coli	Campylobacter	Negative
AgProtect_2254	Streptococcus_pyogenes	Streptococcus	Positive
AgProtect_2253	Escherichia_coli	Escherichia	Negative
AgProtect_2252	Helicobacter_pylori	Helicobacter	Negative
AgProtect_2251	Streptococcus_pneumoniae	Streptococcus	Positive
AgProtect_2250	Escherichia_coli	Escherichia	Negative
AgProtect_225	Borreliella_burgdorferi	Borreliella	Negative
AgProtect_2249	Helicobacter_pylori	Helicobacter	Negative
AgProtect_2248	Streptococcus_pneumoniae	Streptococcus	Positive
AgProtect_2247	Staphylococcus_aureus	Staphylococcus	Positive
AgProtect_2246	Chlamydia_pneumoniae	Chlamydia	Negative
AgProtect_2245	Chlamydia_pneumoniae	Chlamydia	Negative
AgProtect_2244	Helicobacter_pylori	Helicobacter	Negative
AgProtect_2243	Burkholderia_pseudomallei	Burkholderia	Negative
AgProtect_2242	Escherichia_coli	Escherichia	Negative
AgProtect_2241	Treponema_pallidum	Treponema	Negative
AgProtect_2240	Streptococcus_pyogenes	Streptococcus	Positive
AgProtect_224	Borreliella_burgdorferi	Borreliella	Negative
AgProtect_2239	Klebsiella_michiganensis	Klebsiella	Negative
AgProtect_2238	Edwardsiella_tarda	Edwardsiella	Negative
AgProtect_2237	Escherichia_coli	Escherichia	Negative
AgProtect_2236	Staphylococcus_aureus	Staphylococcus	Positive
AgProtect_2235	Staphylococcus_aureus	Staphylococcus	Positive
AgProtect_2234	Borreliella_burgdorferi	Borreliella	Negative
AgProtect_2233	Campylobacter_jejuni	Campylobacter	Negative
AgProtect_2232	Mycobacterium_tuberculosis	Mycobacterium	Positive_with_OM
AgProtect_2231	Streptococcus_pneumoniae	Streptococcus	Positive
AgProtect_2230	Campylobacter_jejuni	Campylobacter	Negative
AgProtect_223	Vibrio_anguillarum	Vibrio	Negative
AgProtect_2229	Escherichia_coli	Escherichia	Negative
AgProtect_2228	Pseudomonas_aeruginosa	Pseudomonas	Negative
AgProtect_2227	Chlamydia_trachomatis	Chlamydia	Negative
AgProtect_2226	Escherichia_coli	Escherichia	Negative
AgProtect_2225	Escherichia_coli	Escherichia	Negative
AgProtect_2224	Pandoraea_pnomenusa	Pandoraea	Negative
AgProtect_2223	Salmonella_enterica_serovar_Enteritidis	Salmonella	Negative
AgProtect_2222	Salmonella_enterica_serovar_Enteritidis	Salmonella	Negative
AgProtect_2221	Pseudomonas_aeruginosa	Pseudomonas	Negative
AgProtect_2220	Pseudomonas_aeruginosa	Pseudomonas	Negative
AgProtect_222	Helicobacter_pylori	Helicobacter	Negative
AgProtect_2219	Riemerella_anatipestifer	Riemerella	Negative
AgProtect_2218	Salmonella_enterica_serovar_Enteritidis	Salmonella	Negative
AgProtect_2217	Brachyspira_hyodysenteriae	Brachyspira	Negative
AgProtect_2216	Salmonella_enterica_serovar_Typhi	Salmonella	Negative
AgProtect_2215	Salmonella_enterica_serovar_Dublin	Salmonella	Negative
AgProtect_2214	Salmonella_enterica_serovar_Pullorum	Salmonella	Negative
AgProtect_2213	Mesomycoplasma_hyopneumoniae	Mesomycoplasma	Negative_without_OM
AgProtect_2212	Mesomycoplasma_hyopneumoniae	Mesomycoplasma	Negative_without_OM
AgProtect_2211	Mycobacterium_leprae	Mycobacterium	Positive_with_OM
AgProtect_2210	Ehrlichia_chaffeensis	Ehrlichia	Negative
AgProtect_221	Helicobacter_pylori	Helicobacter	Negative
AgProtect_2209	Mycobacterium_tuberculosis	Mycobacterium	Positive_with_OM
AgProtect_2208	Mycobacterium_tuberculosis	Mycobacterium	Positive_with_OM
AgProtect_2207	Mycobacterium_tuberculosis	Mycobacterium	Positive_with_OM
AgProtect_2206	Mycobacterium_tuberculosis	Mycobacterium	Positive_with_OM
AgProtect_2205	Mycobacterium_tuberculosis	Mycobacterium	Positive_with_OM
AgProtect_2204	Mycobacterium_tuberculosis	Mycobacterium	Positive_with_OM
AgProtect_2203	Mycobacterium_tuberculosis	Mycobacterium	Positive_with_OM
AgProtect_2202	Mycobacterium_tuberculosis	Mycobacterium	Positive_with_OM
AgProtect_2201	Mycobacterium_tuberculosis	Mycobacterium	Positive_with_OM
AgProtect_2200	Mycobacterium_tuberculosis	Mycobacterium	Positive_with_OM
AgProtect_220	Helicobacter_pylori	Helicobacter	Negative
AgProtect_22	Chlamydia_muridarum	Chlamydia	Negative
AgProtect_2199	Mycobacterium_tuberculosis	Mycobacterium	Positive_with_OM
AgProtect_2198	Mycobacterium_tuberculosis	Mycobacterium	Positive_with_OM
AgProtect_2197	Mycobacterium_tuberculosis	Mycobacterium	Positive_with_OM
AgProtect_2196	Mycobacterium_tuberculosis	Mycobacterium	Positive_with_OM
AgProtect_2195	Mycobacterium_tuberculosis	Mycobacterium	Positive_with_OM
AgProtect_2194	Mycobacterium_tuberculosis	Mycobacterium	Positive_with_OM
AgProtect_2193	Mycobacterium_tuberculosis	Mycobacterium	Positive_with_OM
AgProtect_2192	Mycobacterium_tuberculosis	Mycobacterium	Positive_with_OM
AgProtect_2191	Mycobacterium_tuberculosis	Mycobacterium	Positive_with_OM
AgProtect_2190	Mycobacterium_tuberculosis	Mycobacterium	Positive_with_OM
AgProtect_219	Helicobacter_pylori	Helicobacter	Negative
AgProtect_2189	Mycobacterium_tuberculosis	Mycobacterium	Positive_with_OM
AgProtect_2188	Mycobacterium_tuberculosis	Mycobacterium	Positive_with_OM
AgProtect_2187	Mycobacterium_tuberculosis	Mycobacterium	Positive_with_OM
AgProtect_2186	Mycobacterium_tuberculosis	Mycobacterium	Positive_with_OM
AgProtect_2185	Mycobacterium_tuberculosis	Mycobacterium	Positive_with_OM
AgProtect_2184	Mycobacterium_tuberculosis	Mycobacterium	Positive_with_OM
AgProtect_2183	Mycobacterium_tuberculosis	Mycobacterium	Positive_with_OM
AgProtect_2182	Mycobacterium_tuberculosis	Mycobacterium	Positive_with_OM
AgProtect_2181	Mycobacterium_tuberculosis	Mycobacterium	Positive_with_OM
AgProtect_2180	Mycobacterium_tuberculosis	Mycobacterium	Positive_with_OM
AgProtect_218	Helicobacter_pylori	Helicobacter	Negative
AgProtect_2179	Mycobacterium_tuberculosis	Mycobacterium	Positive_with_OM
AgProtect_2178	Mycobacterium_tuberculosis	Mycobacterium	Positive_with_OM
AgProtect_2177	Mycobacterium_tuberculosis	Mycobacterium	Positive_with_OM
AgProtect_2176	Mycobacterium_tuberculosis	Mycobacterium	Positive_with_OM
AgProtect_2175	Mycobacterium_tuberculosis	Mycobacterium	Positive_with_OM
AgProtect_2174	Mycobacterium_tuberculosis	Mycobacterium	Positive_with_OM
AgProtect_2173	Mycobacterium_tuberculosis	Mycobacterium	Positive_with_OM
AgProtect_2172	Mycobacterium_tuberculosis	Mycobacterium	Positive_with_OM
AgProtect_2171	Mycobacterium_tuberculosis	Mycobacterium	Positive_with_OM
AgProtect_2170	Mycobacterium_tuberculosis	Mycobacterium	Positive_with_OM
AgProtect_217	Yersinia_enterocolitica	Yersinia	Negative
AgProtect_2169	Mycobacterium_tuberculosis	Mycobacterium	Positive_with_OM
AgProtect_2168	Mycobacterium_tuberculosis	Mycobacterium	Positive_with_OM
AgProtect_2167	Mycobacterium_tuberculosis	Mycobacterium	Positive_with_OM
AgProtect_2166	Mycobacterium_tuberculosis	Mycobacterium	Positive_with_OM
AgProtect_2165	Mycobacterium_tuberculosis	Mycobactium	Positive_with_OM
AgProtect_2164	Mycobacterium_tuberculosis	Mycobacterium	Positive_with_OM
AgProtect_2163	Mycobacterium_tuberculosis	Mycobacterium	Positive_with_OM
AgProtect_2162	Mycobacterium_tuberculosis	Mycobacterium	Positive_with_OM
AgProtect_2161	Mycobacterium_tuberculosis	Mycobactium	Positive_with_OM
AgProtect_2160	Mycobacterium_tuberculosis	Mycobacterium	Positive_with_OM
AgProtect_216	Rickettsia_prowazekii	Rickettsia	Negative
AgProtect_2159	Mycobacterium_tuberculosis	Mycobacterium	Positive_with_OM
AgProtect_2158	Mycobacterium_tuberculosis	Mycobacterium	Positive_with_OM
AgProtect_2157	Mycobacterium_tuberculosis	Mycobacterium	Positive_with_OM
AgProtect_2156	Mycobacterium_tuberculosis	Mycobacterium	Positive_with_OM
AgProtect_2155	Mycobacterium_tuberculosis	Mycobacterium	Positive_with_OM
AgProtect_2154	Mycobacterium_tuberculosis	Mycobacterium	Positive_with_OM
AgProtect_2153	Mycobacterium_tuberculosis	Mycobacterium	Positive_with_OM
AgProtect_2152	Mycobacterium_tuberculosis	Mycobacterium	Positive_with_OM
AgProtect_2151	Mycobacterium_tuberculosis	Mycobacterium	Positive_with_OM
AgProtect_2150	Mycobacterium_tuberculosis	Mycobacterium	Positive_with_OM
AgProtect_215	Chlamydia_psittaci	Chlamydia	Negative
AgProtect_2149	Mycobacterium_tuberculosis	Mycobacterium	Positive_with_OM
AgProtect_2148	Mycobacterium_tuberculosis	Mycobacterium	Positive_with_OM
AgProtect_2147	Mycobacterium_tuberculosis	Mycobacterium	Positive_with_OM
AgProtect_2146	Mycobacterium_tuberculosis	Mycobacterium	Positive_with_OM
AgProtect_2145	Mycobacterium_tuberculosis	Mycobacterium	Positive_with_OM
AgProtect_2144	Mycobacterium_tuberculosis	Mycobacterium	Positive_with_OM
AgProtect_2143	Mycobacterium_tuberculosis	Mycobacterium	Positive_with_OM
AgProtect_2142	Mycobacterium_tuberculosis	Mycobacterium	Positive_with_OM
AgProtect_2141	Leptospira_interrogans	Leptospira	Negative
AgProtect_2140	Brucella_melitensis	Brucella	Negative
AgProtect_214	Burkholderia_pseudomallei	Burkholderia	Negative
AgProtect_2139	Brucella_melitensis	Brucella	Negative
AgProtect_2138	Helicobacter_pylori	Helicobacter	Negative
AgProtect_2137	Mycobacterium_tuberculosis	Mycobacterium	Positive_with_OM
AgProtect_2136	Treponema_pallidum	Treponema	Negative
AgProtect_2135	Mycobacterium_tuberculosis	Mycobacterium	Positive_with_OM
AgProtect_2134	Mycobacterium_tuberculosis	Mycobacterium	Positive_with_OM
AgProtect_2133	Mycobacterium_tuberculosis	Mycobacterium	Positive_with_OM
AgProtect_2132	Mycobacterium_tuberculosis	Mycobacterium	Positive_with_OM
AgProtect_2131	Mycobacterium_tuberculosis	Mycobacterium	Positive_with_OM
AgProtect_2130	Mycobacterium_tuberculosis	Mycobactium	Positive_with_OM
AgProtect_213	Corynebacterium_diphtheriae	Corynebacterium	Positive_with_OM
AgProtect_2129	Mycobacterium_tuberculosis	Mycobacterium	Positive_with_OM
AgProtect_2128	Mycobacterium_tuberculosis	Mycobacterium	Positive_with_OM
AgProtect_2127	Mycobacterium_tuberculosis	Mycobacterium	Positive_with_OM
AgProtect_2126	Mycobacterium_tuberculosis	Mycobacterium	Positive_with_OM
AgProtect_2125	Mycobacterium_tuberculosis	Mycobacterium	Positive_with_OM
AgProtect_2124	Mycobacterium_tuberculosis	Mycobacterium	Positive_with_OM
AgProtect_2123	Mycobacterium_tuberculosis	Mycobacterium	Positive_with_OM
AgProtect_2122	Mycobacterium_tuberculosis	Mycobacterium	Positive_with_OM
AgProtect_2121	Borreliella_burgdorferi	Borreliella	Negative
AgProtect_2120	Borreliella_burgdorferi	Borreliella	Negative
AgProtect_212	Vibrio_cholerae	Vibrio	Negative
AgProtect_2119	Borreliella_burgdorferi	Borreliella	Negative
AgProtect_2118	Borreliella_burgdorferi	Borreliella	Negative
AgProtect_2117	Borreliella_burgdorferi	Borreliella	Negative
AgProtect_2116	Borreliella_burgdorferi	Borreliella	Negative
AgProtect_2115	Borreliella_burgdorferi	Borreliella	Negative
AgProtect_2114	Mycobacterium_tuberculosis	Mycobacterium	Positive_with_OM
AgProtect_2113	Mycobacterium_tuberculosis	Mycobacterium	Positive_with_OM
AgProtect_2112	Mycobacterium_tuberculosis	Mycobacterium	Positive_with_OM
AgProtect_2111	Mycobacterium_tuberculosis	Mycobacterium	Positive_with_OM
AgProtect_2110	Mycobacterium_tuberculosis	Mycobacterium	Positive_with_OM
AgProtect_211	Vibrio_cholerae	Vibrio	Negative
AgProtect_2109	Mycobacterium_tuberculosis	Mycobacterium	Positive_with_OM
AgProtect_2108	Mycobacterium_tuberculosis	Mycobacterium	Positive_with_OM
AgProtect_2107	Mycobacterium_tuberculosis	Mycobacterium	Positive_with_OM
AgProtect_2106	Mycobacterium_tuberculosis	Mycobacterium	Positive_with_OM
AgProtect_2105	Mycobacterium_tuberculosis	Mycobacterium	Positive_with_OM
AgProtect_2104	Mycobacterium_tuberculosis	Mycobacterium	Positive_with_OM
AgProtect_2103	Mycobacterium_tuberculosis	Mycobacterium	Positive_with_OM
AgProtect_2102	Mycobacterium_tuberculosis	Mycobacterium	Positive_with_OM
AgProtect_2101	Mycobacterium_tuberculosis	Mycobacterium	Positive_with_OM
AgProtect_2100	Leptospira_borgpetersenii	Leptospira	Negative
AgProtect_210	Vibrio_cholerae	Vibrio	Negative
AgProtect_21	Chlamydia_muridarum	Chlamydia	Negative
AgProtect_2099	Mycobacterium_tuberculosis	Mycobacterium	Positive_with_OM
AgProtect_2098	Mycobacterium_tuberculosis	Mycobacterium	Positive_with_OM
AgProtect_2097	Mycobacterium_tuberculosis	Mycobacterium	Positive_with_OM
AgProtect_2096	Mycobacterium_tuberculosis	Mycobacterium	Positive_with_OM
AgProtect_2095	Mycobacterium_tuberculosis	Mycobacterium	Positive_with_OM
AgProtect_2094	Mycobacterium_tuberculosis	Mycobacterium	Positive_with_OM
AgProtect_2093	Mycobacterium_tuberculosis	Mycobacterium	Positive_with_OM
AgProtect_2092	Mycobacterium_tuberculosis	Mycobacterium	Positive_with_OM
AgProtect_2091	Mycobacterium_tuberculosis	Mycobacterium	Positive_with_OM
AgProtect_2090	Mycobacterium_tuberculosis	Mycobacterium	Positive_with_OM
AgProtect_209	Salmonella_enterica_serovar_Typhi	Salmonella	Negative
AgProtect_2089	Mycobacterium_tuberculosis	Mycobacterium	Positive_with_OM
AgProtect_2088	Borreliella_burgdorferi	Borreliella	Negative
AgProtect_2087	Prescottella_equi	Prescottella	Positive_with_OM
AgProtect_2086	Prescottella_equi	Prescottella	Positive_with_OM
AgProtect_2085	Mycolicibacterium_gilvum	Mycolicibacterium	Positive_with_OM
AgProtect_2084	Acinetobacter_baumannii	Acinetobacter	Negative
AgProtect_2083	Mycobacterium_tuberculosis	Mycobacterium	Positive_with_OM
AgProtect_2082	Borreliella_garinii	Borreliella	Negative
AgProtect_2081	Borreliella_garinii	Borreliella	Negative
AgProtect_2080	Mycobacterium_kansasii	Mycobacterium	Positive_with_OM
AgProtect_208	Salmonella_enterica_serovar_Typhi	Salmonella	Negative
AgProtect_2079	Mycobacterium_kansasii	Mycobacterium	Positive_with_OM
AgProtect_2078	Chlamydia_pecorum	Chlamydia	Negative
AgProtect_2077	Mycobacterium_ulcerans	Mycobacterium	Positive_with_OM
AgProtect_2076	Borrelia_miyamotoi	Borrelia	Negative
AgProtect_2075	Borrelia_miyamotoi	Borrelia	Negative
AgProtect_2074	Borrelia_miyamotoi	Borrelia	Negative
AgProtect_2073	Borrelia_miyamotoi	Borrelia	Negative
AgProtect_2072	Borrelia_miyamotoi	Borrelia	Negative
AgProtect_2071	Borrelia_miyamotoi	Borrelia	Negative
AgProtect_2070	Borrelia_miyamotoi	Borrelia	Negative
AgProtect_207	Salmonella_enterica_serovar_Typhimurium	Salmonella	Negative
AgProtect_2069	Borrelia_miyamotoi	Borrelia	Negative
AgProtect_2068	Borrelia_miyamotoi	Borrelia	Negative
AgProtect_2067	Chlamydia_suis	Chlamydia	Negative
AgProtect_2066	Chlamydia_suis	Chlamydia	Negative
AgProtect_2065	Chlamydia_pecorum	Chlamydia	Negative
AgProtect_2064	Chlamydia_pecorum	Chlamydia	Negative
AgProtect_2063	Chlamydia_pecorum	Chlamydia	Negative
AgProtect_2062	Streptococcus_oralis	Streptococcus	Positive
AgProtect_2061	Borrelia_miyamotoi	Borrelia	Negative
AgProtect_2060	Borrelia_miyamotoi	Borrelia	Negative
AgProtect_206	Rickettsia_rickettsii	Rickettsia	Negative
AgProtect_2059	Mycoplasmopsis_bovis	Mycoplasmopsis	Negative_without_OM
AgProtect_2058	Mycoplasmopsis_bovis	Mycoplasmopsis	Negative_without_OM
AgProtect_2057	Mycoplasmopsis_bovis	Mycoplasmopsis	Negative_without_OM
AgProtect_2056	Mycobacterium_tuberculosis	Mycobacterium	Positive_with_OM
AgProtect_2055	Moraxella_catarrhalis	Moraxella	Negative
AgProtect_2054	Mycobacteroides_abscessus	Mycobacteroides	Positive_with_OM
AgProtect_2053	Mycobacterium_tuberculosis	Mycobacterium	Positive_with_OM
AgProtect_2052	Mycobacterium_tuberculosis	Mycobacterium	Positive_with_OM
AgProtect_2051	Mycobacterium_tuberculosis	Mycobacterium	Positive_with_OM
AgProtect_2050	Streptococcus_suis	Streptococcus	Positive
AgProtect_205	Rickettsia_rickettsii	Rickettsia	Negative
AgProtect_2049	Ehrlichia_ruminantium	Ehrlichia	Negative
AgProtect_2048	Klebsiella_pneumoniae	Klebsiella	Negative
AgProtect_2047	Oceanobacillus_oncorhynchi	Oceanobacillus	Positive
AgProtect_2046	Anaplasma_phagocytophilum	Anaplasma	Negative
AgProtect_2045	Anaplasma_phagocytophilum	Anaplasma	Negative
AgProtect_2044	Porphyromonas_gingivalis	Porphyromonas	Negative
AgProtect_2043	Mycobacterium_ulcerans	Mycobacterium	Positive_with_OM
AgProtect_2042	Mycobacterium_ulcerans	Mycobacterium	Positive_with_OM
AgProtect_2041	Mycobacterium_ulcerans	Mycobacterium	Positive_with_OM
AgProtect_2040	Mycobacterium_ulcerans	Mycobacterium	Positive_with_OM
AgProtect_204	Streptococcus_equi	Streptococcus	Positive
AgProtect_2039	Mannheimia_haemolytica	Mannheimia	Negative
AgProtect_2038	Chlamydia_muridarum	Chlamydia	Negative
AgProtect_2037	Chlamydia_trachomatis	Chlamydia	Negative
AgProtect_2036	Chlamydia_pecorum	Chlamydia	Negative
AgProtect_2035	Chlamydia_felis	Chlamydia	Negative
AgProtect_2034	Chlamydia_caviae	Chlamydia	Negative
AgProtect_2033	Bordetella_bronchiseptica	Bordetella	Negative
AgProtect_2032	Erysipelothrix_rhusiopathiae	Erysipelothrix	Positive
AgProtect_2031	Clostridium_perfringens	Clostridium	Positive
AgProtect_2030	Clostridium_perfringens	Clostridium	Positive
AgProtect_203	Streptococcus_equi	Streptococcus	Positive
AgProtect_2029	Clostridium_perfringens	Clostridium	Positive
AgProtect_2028	Clostridium_perfringens	Clostridium	Positive
AgProtect_2027	Clostridium_perfringens	Clostridium	Positive
AgProtect_2026	Clostridium_perfringens	Clostridium	Positive
AgProtect_2025	Clostridium_perfringens	Clostridium	Positive
AgProtect_2024	Clostridium_perfringens	Clostridium	Positive
AgProtect_2023	Clostridium_perfringens	Clostridium	Positive
AgProtect_2022	Clostridium_perfringens	Clostridium	Positive
AgProtect_2021	Bordetella_pertussis	Bordetella	Negative
AgProtect_2020	Actinobacillus_pleuropneumoniae	Actinobacillus	Negative
AgProtect_202	Streptococcus_equi	Streptococcus	Positive
AgProtect_2019	Actinobacillus_pleuropneumoniae	Actinobacillus	Negative
AgProtect_2018	Acinetobacter_baumannii	Acinetobacter	Negative
AgProtect_2017	Clostridium_botulinum	Clostridium	Positive
AgProtect_2016	Clostridium_botulinum	Clostridium	Positive
AgProtect_2015	Clostridium_botulinum	Clostridium	Positive
AgProtect_2014	Chlamydia_trachomatis	Chlamydia	Negative
AgProtect_2013	Chlamydia_trachomatis	Chlamydia	Negative
AgProtect_2012	Chlamydia_psittaci	Chlamydia	Negative
AgProtect_2011	Campylobacter_jejuni	Campylobacter	Negative
AgProtect_2010	Campylobacter_jejuni	Campylobacter	Negative
AgProtect_201	Streptococcus_equi	Streptococcus	Positive
AgProtect_2009	Campylobacter_jejuni	Campylobacter	Negative
AgProtect_2008	Bordetella_bronchiseptica	Bordetella	Negative
AgProtect_2007	Yersinia_pestis	Yersinia	Negative
AgProtect_2006	Neisseria_meningitidis	Neisseria	Negative
AgProtect_2005	Streptococcus_pyogenes	Streptococcus	Positive
AgProtect_2005	Streptococcus_pyogenes	Streptococcus	Positive
AgProtect_2004	Streptococcus_pyogenes	Streptococcus	Positive
AgProtect_2004	Streptococcus_pyogenes	Streptococcus	Positive
AgProtect_2003	Streptococcus_pneumoniae	Streptococcus	Positive
AgProtect_2002	Mycobacterium_tuberculosis	Mycobacterium	Positive_with_OM
AgProtect_2001	Mycobacterium_tuberculosis	Mycobacterium	Positive_with_OM
AgProtect_2000	Streptococcus_agalactiae	Streptococcus	Positive
AgProtect_200	Streptococcus_equi	Streptococcus	Positive
AgProtect_20	Chlamydia_muridarum	Chlamydia	Negative
AgProtect_2	Bacillus_anthracis	Bacillus	Positive
AgProtect_1999	Neisseria_meningitidis	Neisseria	Negative
AgProtect_1998	Streptococcus_pneumoniae	Streptococcus	Positive
AgProtect_1997	Neisseria_meningitidis	Neisseria	Negative
AgProtect_1996	Mycobacterium_tuberculosis	Mycobacterium	Positive_with_OM
AgProtect_1995	Klebsiella_pneumoniae	Klebsiella	Negative
AgProtect_1994	Mycobacterium_tuberculosis	Mycobacterium	Positive_with_OM
AgProtect_1993	Chlamydia_trachomatis	Chlamydia	Negative
AgProtect_1992	Mycobacterium_tuberculosis	Mycobacterium	Positive_with_OM
AgProtect_1991	Leptospira_interrogans	Leptospira	Negative
AgProtect_1990	Mycobacterium_leprae	Mycobacterium	Positive_with_OM
AgProtect_199	Streptococcus_pneumoniae	Streptococcus	Positive
AgProtect_1989	Streptococcus_pyogenes	Streptococcus	Positive
AgProtect_1989	Streptococcus_pyogenes	Streptococcus	Positive
AgProtect_1988	Staphylococcus_aureus	Staphylococcus	Positive
AgProtect_1987	Mycobacterium_tuberculosis	Mycobacterium	Positive_with_OM
AgProtect_1986	Streptococcus_pyogenes	Streptococcus	Positive
AgProtect_1986	Streptococcus_pyogenes	Streptococcus	Positive
AgProtect_1985	Mycobacterium_tuberculosis	Mycobacterium	Positive_with_OM
AgProtect_1984	Clostridium_botulinum	Clostridium	Positive
AgProtect_1983	Klebsiella_pneumoniae	Klebsiella	Negative
AgProtect_1982	Streptococcus_pyogenes	Streptococcus	Positive
AgProtect_1982	Streptococcus_pyogenes	Streptococcus	Positive
AgProtect_1981	Orientia_tsutsugamushi	Orientia	Negative
AgProtect_1980	Streptococcus_pneumoniae	Streptococcus	Positive
AgProtect_198	Streptococcus_pneumoniae	Streptococcus	Positive
AgProtect_1979	Mycobacterium_tuberculosis	Mycobacterium	Positive_with_OM
AgProtect_1978	Neisseria_meningitidis	Neisseria	Negative
AgProtect_1977	Mycobacterium_tuberculosis	Mycobacterium	Positive_with_OM
AgProtect_1976	Mycobacterium_tuberculosis	Mycobacterium	Positive_with_OM
AgProtect_1975	Borreliella_burgdorferi	Borreliella	Negative
AgProtect_1974	Chlamydia_muridarum	Chlamydia	Negative
AgProtect_1973	Streptococcus_pneumoniae	Streptococcus	Positive
AgProtect_1972	Streptococcus_agalactiae	Streptococcus	Positive
AgProtect_1971	Mycobacterium_tuberculosis	Mycobacterium	Positive_with_OM
AgProtect_1970	Mycobacterium_tuberculosis	Mycobacterium	Positive_with_OM
AgProtect_197	Streptococcus_pneumoniae	Streptococcus	Positive
AgProtect_1969	Streptococcus_pyogenes	Streptococcus	Positive
AgProtect_1969	Streptococcus_pyogenes	Streptococcus	Positive
AgProtect_1968	Streptococcus_pneumoniae	Streptococcus	Positive
AgProtect_1967	Mycobacterium_tuberculosis	Mycobacterium	Positive_with_OM
AgProtect_1966	Neisseria_meningitidis	Neisseria	Negative
AgProtect_1965	Streptococcus_pyogenes	Streptococcus	Positive
AgProtect_1965	Streptococcus_pyogenes	Streptococcus	Positive
AgProtect_1964	Streptococcus_pyogenes	Streptococcus	Positive
AgProtect_1964	Streptococcus_pyogenes	Streptococcus	Positive
AgProtect_1963	Mycobacterium_tuberculosis	Mycobacterium	Positive_with_OM
AgProtect_1962	Streptococcus_mutans	Streptococcus	Positive
AgProtect_1961	Klebsiella_pneumoniae	Klebsiella	Negative
AgProtect_1960	Streptococcus_pneumoniae	Streptococcus	Positive
AgProtect_196	Streptococcus_pneumoniae	Streptococcus	Positive
AgProtect_1959	Helicobacter_pylori	Helicobacter	Negative
AgProtect_1958	Clostridium_botulinum	Clostridium	Positive
AgProtect_1957	Mycobacterium_tuberculosis	Mycobacterium	Positive_with_OM
AgProtect_1956	Streptococcus_pyogenes	Streptococcus	Positive
AgProtect_1956	Streptococcus_pyogenes	Streptococcus	Positive
AgProtect_1955	Brucella_abortus	Brucella	Negative
AgProtect_1954	Chlamydia_trachomatis	Chlamydia	Negative
AgProtect_1953	Mycobacterium_tuberculosis	Mycobacterium	Positive_with_OM
AgProtect_1952	Mycobacterium_tuberculosis	Mycobacterium	Positive_with_OM
AgProtect_1951	Mycobacterium_tuberculosis	Mycobacterium	Positive_with_OM
AgProtect_1950	Klebsiella_pneumoniae	Klebsiella	Negative
AgProtect_195	Streptococcus_pneumoniae	Streptococcus	Positive
AgProtect_1949	Staphylococcus_aureus	Staphylococcus	Positive
AgProtect_1948	Mycobacterium_tuberculosis	Mycobacterium	Positive_with_OM
AgProtect_1947	Streptococcus_pneumoniae	Streptococcus	Positive
AgProtect_1946	Mycobacterium_tuberculosis	Mycobacterium	Positive_with_OM
AgProtect_1945	Mycobacterium_tuberculosis	Mycobacterium	Positive_with_OM
AgProtect_1944	Mycobacterium_abscessus	Mycobacterium	Positive_with_OM
AgProtect_1943	Pseudomonas_aeruginosa	Pseudomonas	Negative
AgProtect_1942	Mycobacterium_tuberculosis	Mycobacterium	Positive_with_OM
AgProtect_1941	Mycobacterium_tuberculosis	Mycobacterium	Positive_with_OM
AgProtect_1940	Porphyromonas_gingivalis	Porphyromonas	Negative
AgProtect_194	Streptococcus_pneumoniae	Streptococcus	Positive
AgProtect_1939	Leptospira_interrogans	Leptospira	Negative
AgProtect_1938	Bordetella_pertussis	Bordetella	Negative
AgProtect_1937	Streptococcus_pneumoniae	Streptococcus	Positive
AgProtect_1936	Streptococcus_pyogenes	Streptococcus	Positive
AgProtect_1936	Streptococcus_pyogenes	Streptococcus	Positive
AgProtect_1935	Escherichia_coli	Escherichia	Negative
AgProtect_1934	Streptococcus_pneumoniae	Streptococcus	Positive
AgProtect_1933	Helicobacter_pylori	Helicobacter	Negative
AgProtect_1932	Staphylococcus_aureus	Staphylococcus	Positive
AgProtect_1931	Streptococcus_agalactiae	Streptococcus	Positive
AgProtect_1930	Streptococcus_pneumoniae	Streptococcus	Positive
AgProtect_193	Streptococcus_pneumoniae	Streptococcus	Positive
AgProtect_1929	Mycobacterium_tuberculosis	Mycobacterium	Positive_with_OM
AgProtect_1928	Escherichia_coli	Escherichia	Negative
AgProtect_1927	Streptococcus_pyogenes	Streptococcus	Positive
AgProtect_1927	Streptococcus_pyogenes	Streptococcus	Positive
AgProtect_1926	Streptococcus_pyogenes	Streptococcus	Positive
AgProtect_1926	Streptococcus_pyogenes	Streptococcus	Positive
AgProtect_1925	Pseudomonas_aeruginosa	Pseudomonas	Negative
AgProtect_1924	Chlamydia_trachomatis	Chlamydia	Negative
AgProtect_1923	Mycobacterium_tuberculosis	Mycobacterium	Positive_with_OM
AgProtect_1922	Mycobacterium_tuberculosis	Mycobacterium	Positive_with_OM
AgProtect_1921	Mesomycoplasma_hyopneumoniae	Mesomycoplasma	Negative_without_OM
AgProtect_1920	Mycobacterium_abscessus	Mycobacterium	Positive_with_OM
AgProtect_192	Streptococcus_pneumoniae	Streptococcus	Positive
AgProtect_1919	Yersinia_pseudotuberculosis	Yersinia	Negative
AgProtect_1918	Salmonella_enterica_serovar_Typhi	Salmonella	Negative
AgProtect_1917	Streptococcus_pyogenes	Streptococcus	Positive
AgProtect_1917	Streptococcus_pyogenes	Streptococcus	Positive
AgProtect_1916	Staphylococcus_aureus	Staphylococcus	Positive
AgProtect_1915	Streptococcus_pyogenes	Streptococcus	Positive
AgProtect_1915	Streptococcus_pyogenes	Streptococcus	Positive
AgProtect_1914	Neisseria_meningitidis	Neisseria	Negative
AgProtect_1913	Haemophilus_influenzae	Haemophilus	Negative
AgProtect_1912	Streptococcus_pyogenes	Streptococcus	Positive
AgProtect_1912	Streptococcus_pyogenes	Streptococcus	Positive
AgProtect_1911	Mycobacterium_tuberculosis	Mycobacterium	Positive_with_OM
AgProtect_1910	Mesomycoplasma_hyopneumoniae	Mesomycoplasma	Negative_without_OM
AgProtect_191	Streptococcus_pneumoniae	Streptococcus	Positive
AgProtect_1909	Mycobacterium_tuberculosis	Mycobacterium	Positive_with_OM
AgProtect_1908	Mycobacterium_tuberculosis	Mycobacterium	Positive_with_OM
AgProtect_1907	Streptococcus_pyogenes	Streptococcus	Positive
AgProtect_1907	Streptococcus_pyogenes	Streptococcus	Positive
AgProtect_1906	Streptococcus_pyogenes	Streptococcus	Positive
AgProtect_1906	Streptococcus_pyogenes	Streptococcus	Positive
AgProtect_1905	Leptospira_interrogans	Leptospira	Negative
AgProtect_1904	Helicobacter_pylori	Helicobacter	Negative
AgProtect_1903	Neisseria_meningitidis	Neisseria	Negative
AgProtect_1902	Acinetobacter_baumannii	Acinetobacter	Negative
AgProtect_1901	Shigella_dysenteriae	Shigella	Negative
AgProtect_1900	Klebsiella_pneumoniae	Klebsiella	Negative
AgProtect_190	Streptococcus_pneumoniae	Streptococcus	Positive
AgProtect_19	Chlamydia_muridarum	Chlamydia	Negative
AgProtect_1899	Neisseria_meningitidis	Neisseria	Negative
AgProtect_1898	Streptococcus_pyogenes	Streptococcus	Positive
AgProtect_1898	Streptococcus_pyogenes	Streptococcus	Positive
AgProtect_1897	Neisseria_meningitidis	Neisseria	Negative
AgProtect_1896	Staphylococcus_aureus	Staphylococcus	Positive
AgProtect_1895	Streptococcus_pneumoniae	Streptococcus	Positive
AgProtect_1894	Streptococcus_pneumoniae	Streptococcus	Positive
AgProtect_1893	Leptospira_interrogans	Leptospira	Negative
AgProtect_1892	Clostridium_botulinum	Clostridium	Positive
AgProtect_1891	Vibrio_cholerae	Vibrio	Negative
AgProtect_1890	Vibrio_cholerae	Vibrio	Negative
AgProtect_189	Streptococcus_pneumoniae	Streptococcus	Positive
AgProtect_1889	Streptococcus_pyogenes	Streptococcus	Positive
AgProtect_1889	Streptococcus_pyogenes	Streptococcus	Positive
AgProtect_1888	Streptococcus_pneumoniae	Streptococcus	Positive
AgProtect_1887	Mycobacterium_tuberculosis	Mycobacterium	Positive_with_OM
AgProtect_1886	Streptococcus_pyogenes	Streptococcus	Positive
AgProtect_1886	Streptococcus_pyogenes	Streptococcus	Positive
AgProtect_1885	Escherichia_coli	Escherichia	Negative
AgProtect_1884	Neisseria_meningitidis	Neisseria	Negative
AgProtect_1883	Escherichia_coli	Escherichia	Negative
AgProtect_1882	Clostridioides_difficile	Clostridioides	Positive
AgProtect_1881	Streptococcus_pyogenes	Streptococcus	Positive
AgProtect_1881	Streptococcus_pyogenes	Streptococcus	Positive
AgProtect_1880	Borreliella_burgdorferi	Borreliella	Negative
AgProtect_188	Neisseria_meningitidis	Neisseria	Negative
AgProtect_1879	Mycobacterium_tuberculosis	Mycobacterium	Positive_with_OM
AgProtect_1878	Escherichia_coli	Escherichia	Negative
AgProtect_1877	Mycobacterium_tuberculosis	Mycobacterium	Positive_with_OM
AgProtect_1876	Vibrio_cholerae	Vibrio	Negative
AgProtect_1875	Neisseria_meningitidis	Neisseria	Negative
AgProtect_1874	Mesomycoplasma_hyopneumoniae	Mesomycoplasma	Negative_without_OM
AgProtect_1873	Mycobacterium_tuberculosis	Mycobacterium	Positive_with_OM
AgProtect_1872	Chlamydia_trachomatis	Chlamydia	Negative
AgProtect_1871	Mycobacterium_tuberculosis	Mycobacterium	Positive_with_OM
AgProtect_1870	Mycobacterium_tuberculosis	Mycobacterium	Positive_with_OM
AgProtect_187	Neisseria_meningitidis	Neisseria	Negative
AgProtect_1869	Streptococcus_pyogenes	Streptococcus	Positive
AgProtect_1869	Streptococcus_pyogenes	Streptococcus	Positive
AgProtect_1868	Brucella_abortus	Brucella	Negative
AgProtect_1867	Streptococcus_pyogenes	Streptococcus	Positive
AgProtect_1867	Streptococcus_pyogenes	Streptococcus	Positive
AgProtect_1866	Mycobacterium_tuberculosis	Mycobacterium	Positive_with_OM
AgProtect_1865	Streptococcus_agalactiae	Streptococcus	Positive
AgProtect_1864	Escherichia_coli	Escherichia	Negative
AgProtect_1863	Streptococcus_pneumoniae	Streptococcus	Positive
AgProtect_1862	Streptococcus_pyogenes	Streptococcus	Positive
AgProtect_1862	Streptococcus_pyogenes	Streptococcus	Positive
AgProtect_1861	Mycobacterium_tuberculosis	Mycobacterium	Positive_with_OM
AgProtect_1860	Porphyromonas_gingivalis	Porphyromonas	Negative
AgProtect_186	Neisseria_meningitidis	Neisseria	Negative
AgProtect_1859	Escherichia_coli	Escherichia	Negative
AgProtect_1858	Streptococcus_pneumoniae	Streptococcus	Positive
AgProtect_1857	Clostridioides_difficile	Clostridioides	Positive
AgProtect_1856	Klebsiella_pneumoniae	Klebsiella	Negative
AgProtect_1855	Helicobacter_pylori	Helicobacter	Negative
AgProtect_1854	Mycobacterium_tuberculosis	Mycobacterium	Positive_with_OM
AgProtect_1853	Streptococcus_pneumoniae	Streptococcus	Positive
AgProtect_1852	Leptospira_interrogans	Leptospira	Negative
AgProtect_1851	Escherichia_coli	Escherichia	Negative
AgProtect_1850	Streptococcus_pneumoniae	Streptococcus	Positive
AgProtect_185	Neisseria_meningitidis	Neisseria	Negative
AgProtect_1849	Neisseria_meningitidis	Neisseria	Negative
AgProtect_1848	Neisseria_meningitidis	Neisseria	Negative
AgProtect_1847	Streptococcus_pyogenes	Streptococcus	Positive
AgProtect_1847	Streptococcus_pyogenes	Streptococcus	Positive
AgProtect_1846	Neisseria_meningitidis	Neisseria	Negative
AgProtect_1845	Mycobacterium_tuberculosis	Mycobacterium	Positive_with_OM
AgProtect_1844	Escherichia_coli	Escherichia	Negative
AgProtect_1843	Streptococcus_pneumoniae	Streptococcus	Positive
AgProtect_1842	Neisseria_meningitidis	Neisseria	Negative
AgProtect_1841	Shigella_dysenteriae	Shigella	Negative
AgProtect_1840	Escherichia_coli	Escherichia	Negative
AgProtect_184	Neisseria_meningitidis	Neisseria	Negative
AgProtect_1839	Streptococcus_pneumoniae	Streptococcus	Positive
AgProtect_1838	Streptococcus_pneumoniae	Streptococcus	Positive
AgProtect_1837	Streptococcus_pyogenes	Streptococcus	Positive
AgProtect_1837	Streptococcus_pyogenes	Streptococcus	Positive
AgProtect_1836	Chlamydia_trachomatis	Chlamydia	Negative
AgProtect_1835	Neisseria_meningitidis	Neisseria	Negative
AgProtect_1834	Streptococcus_pyogenes	Streptococcus	Positive
AgProtect_1834	Streptococcus_pyogenes	Streptococcus	Positive
AgProtect_1833	Escherichia_coli	Escherichia	Negative
AgProtect_1832	Chlamydia_trachomatis	Chlamydia	Negative
AgProtect_1831	Streptococcus_pneumoniae	Streptococcus	Positive
AgProtect_1830	Escherichia_coli	Escherichia	Negative
AgProtect_183	Neisseria_meningitidis	Neisseria	Negative
AgProtect_1829	Borreliella_burgdorferi	Borreliella	Negative
AgProtect_1828	Haemophilus_influenzae	Haemophilus	Negative
AgProtect_1827	Bacillus_anthracis	Bacillus	Positive
AgProtect_1826	Neisseria_meningitidis	Neisseria	Negative
AgProtect_1825	Campylobacter_jejuni	Campylobacter	Negative
AgProtect_1824	Yersinia_pestis	Yersinia	Negative
AgProtect_1823	Corynebacterium_pseudotuberculosis	Corynebacterium	Positive_with_OM
AgProtect_1822	Clostridium_tetani	Clostridium	Positive
AgProtect_1821	Bordetella_pertussis	Bordetella	Negative
AgProtect_1820	Bacillus_anthracis	Bacillus	Positive
AgProtect_182	Mycoplasma_gallisepticum	Mycoplasma	Negative_without_OM
AgProtect_1819	Streptococcus_pneumoniae	Streptococcus	Positive
AgProtect_1818	Borreliella_burgdorferi	Borreliella	Negative
AgProtect_1817	Escherichia_coli	Escherichia	Negative
AgProtect_1816	Neisseria_meningitidis	Neisseria	Negative
AgProtect_1815	Vibrio_parahaemolyticus	Vibrio	Negative
AgProtect_1814	Salmonella_enterica_serovar_choleraesuis	Salmonella	Negative
AgProtect_1813	Mycobacterium_tuberculosis	Mycobacterium	Positive_with_OM
AgProtect_1812	Escherichia_coli	Escherichia	Negative
AgProtect_1811	Streptococcus_agalactiae	Streptococcus	Positive
AgProtect_1810	Helicobacter_pylori	Helicobacter	Negative
AgProtect_181	Mycobacterium_tuberculosis	Mycobacterium	Positive_with_OM
AgProtect_1809	Chlamydia_trachomatis	Chlamydia	Negative
AgProtect_1808	Salmonella_enterica_serovar_Typhimurium	Salmonella	Negative
AgProtect_1807	Listeria_monocytogenes	Listeria	Positive
AgProtect_1806	Helicobacter_pylori	Helicobacter	Negative
AgProtect_1805	Streptococcus_pneumoniae	Streptococcus	Positive
AgProtect_1804	Helicobacter_pylori	Helicobacter	Negative
AgProtect_1803	Clostridium_perfringens	Clostridium	Positive
AgProtect_1802	Escherichia_coli	Escherichia	Negative
AgProtect_1801	Streptococcus_agalactiae	Streptococcus	Positive
AgProtect_1800	Streptococcus_agalactiae	Streptococcus	Positive
AgProtect_180	Mycobacterium_tuberculosis	Mycobacterium	Positive_with_OM
AgProtect_18	Chlamydia_muridarum	Chlamydia	Negative
AgProtect_1799	Streptococcus_agalactiae	Streptococcus	Positive
AgProtect_1798	Salmonella_enterica_serovar_Typhimurium	Salmonella	Negative
AgProtect_1797	Salmonella_enterica_serovar_Typhimurium	Salmonella	Negative
AgProtect_1796	Salmonella_enterica_serovar_Typhimurium	Salmonella	Negative
AgProtect_1795	Salmonella_enterica_serovar_Enteritidis	Salmonella	Negative
AgProtect_1794	Salmonella_enterica_serovar_Enteritidis	Salmonella	Negative
AgProtect_1793	Salmonella_enterica_serovar_Enteritidis	Salmonella	Negative
AgProtect_1792	Salmonella_enterica_serovar_Enteritidis	Salmonella	Negative
AgProtect_1791	Salmonella_enterica_serovar_Enteritidis	Salmonella	Negative
AgProtect_1790	Porphyromonas_gingivalis	Porphyromonas	Negative
AgProtect_179	Borreliella_burgdorferi	Borreliella	Negative
AgProtect_1789	Porphyromonas_gingivalis	Porphyromonas	Negative
AgProtect_1788	Pasteurella_multocida	Pasteurella	Negative
AgProtect_1787	Pasteurella_multocida	Pasteurella	Negative
AgProtect_1786	Pasteurella_multocida	Pasteurella	Negative
AgProtect_1785	Pasteurella_multocida	Pasteurella	Negative
AgProtect_1784	Ornithobacterium_rhinotracheale	Ornithobacterium	Negative
AgProtect_1783	Ornithobacterium_rhinotracheale	Ornithobacterium	Negative
AgProtect_1782	Ornithobacterium_rhinotracheale	Ornithobacterium	Negative
AgProtect_1781	Ornithobacterium_rhinotracheale	Ornithobacterium	Negative
AgProtect_1780	Ornithobacterium_rhinotracheale	Ornithobacterium	Negative
AgProtect_178	Haemophilus_influenzae	Haemophilus	Negative
AgProtect_1779	Ornithobacterium_rhinotracheale	Ornithobacterium	Negative
AgProtect_1778	Ornithobacterium_rhinotracheale	Ornithobacterium	Negative
AgProtect_1777	Ornithobacterium_rhinotracheale	Ornithobacterium	Negative
AgProtect_1776	Ornithobacterium_rhinotracheale	Ornithobacterium	Negative
AgProtect_1775	Ornithobacterium_rhinotracheale	Ornithobacterium	Negative
AgProtect_1774	Ornithobacterium_rhinotracheale	Ornithobacterium	Negative
AgProtect_1773	Ornithobacterium_rhinotracheale	Ornithobacterium	Negative
AgProtect_1772	Ornithobacterium_rhinotracheale	Ornithobacterium	Negative
AgProtect_1771	Ornithobacterium_rhinotracheale	Ornithobacterium	Negative
AgProtect_1770	Ornithobacterium_rhinotracheale	Ornithobacterium	Negative
AgProtect_177	Haemophilus_influenzae	Haemophilus	Negative
AgProtect_1769	Ornithobacterium_rhinotracheale	Ornithobacterium	Negative
AgProtect_1768	Neisseria_meningitidis	Neisseria	Negative
AgProtect_1767	Mycoplasmopsis_synoviae	Mycoplasmopsis	Negative_without_OM
AgProtect_1766	Mycoplasma_gallisepticum	Mycoplasma	Negative_without_OM
AgProtect_1765	Mycoplasma_gallisepticum	Mycoplasma	Negative_without_OM
AgProtect_1764	Mycoplasma_gallisepticum	Mycoplasma	Negative_without_OM
AgProtect_1763	Mycoplasma_gallisepticum	Mycoplasma	Negative_without_OM
AgProtect_1762	Mycoplasma_gallisepticum	Mycoplasma	Negative_without_OM
AgProtect_1761	Mycobacterium_abscessus	Mycobacterium	Positive_with_OM
AgProtect_1760	Mycobacterium_marinum	Mycobacterium	Positive_with_OM
AgProtect_176	Haemophilus_influenzae	Haemophilus	Negative
AgProtect_1759	Mycobacterium_leprae	Mycobacterium	Positive_with_OM
AgProtect_1758	Mycobacterium_avium	Mycobacterium	Positive_with_OM
AgProtect_1757	Mycobacterium_avium	Mycobacterium	Positive_with_OM
AgProtect_1756	Mycobacterium_avium	Mycobacterium	Positive_with_OM
AgProtect_1755	Mycobacterium_avium	Mycobacterium	Positive_with_OM
AgProtect_1754	Mycobacterium_avium	Mycobacterium	Positive_with_OM
AgProtect_1753	Mycobacterium_avium	Mycobacterium	Positive_with_OM
AgProtect_1752	Mycobacterium_avium	Mycobacterium	Positive_with_OM
AgProtect_1751	Mycobacterium_avium	Mycobacterium	Positive_with_OM
AgProtect_1750	Mycobacterium_avium	Mycobacterium	Positive_with_OM
AgProtect_175	Haemophilus_influenzae	Haemophilus	Negative
AgProtect_1749	Mycobacterium_avium	Mycobacterium	Positive_with_OM
AgProtect_1748	Mycobacterium_avium	Mycobacterium	Positive_with_OM
AgProtect_1747	Mycobacterium_avium	Mycobacterium	Positive_with_OM
AgProtect_1746	Mycobacterium_avium	Mycobacterium	Positive_with_OM
AgProtect_1745	Mycobacterium_avium	Mycobacterium	Positive_with_OM
AgProtect_1744	Mycobacterium_avium	Mycobacterium	Positive_with_OM
AgProtect_1743	Mycobacterium_avium	Mycobacterium	Positive_with_OM
AgProtect_1742	Mycobacterium_avium	Mycobacterium	Positive_with_OM
AgProtect_1741	Mannheimia_haemolytica	Mannheimia	Negative
AgProtect_1740	Mannheimia_haemolytica	Mannheimia	Negative
AgProtect_174	Francisella_tularensis	Francisella	Negative
AgProtect_1739	Mannheimia_haemolytica	Mannheimia	Negative
AgProtect_1738	Mycobacterium_ulcerans	Mycobacterium	Positive_with_OM
AgProtect_1737	Mesomycoplasma_hyopneumoniae	Mesomycoplasma	Negative_without_OM
AgProtect_1736	Chlamydia_pecorum	Chlamydia	Negative
AgProtect_1735	Chlamydia_pecorum	Chlamydia	Negative
AgProtect_1734	Chlamydia_pecorum	Chlamydia	Negative
AgProtect_1733	Chlamydia_pecorum	Chlamydia	Negative
AgProtect_1732	Mycolicibacterium_neoaurum	Mycolicibacterium	Positive_with_OM
AgProtect_1731	Enterococcus_saccharolyticus	Enterococcus	Positive
AgProtect_1730	Coxiella_burnetii	Coxiella	Negative
AgProtect_173	Francisella_tularensis	Francisella	Negative
AgProtect_1729	Chlamydia_pneumoniae	Chlamydia	Negative
AgProtect_1728	Chlamydia_pneumoniae	Chlamydia	Negative
AgProtect_1727	Chlamydia_pneumoniae	Chlamydia	Negative
AgProtect_1726	Chlamydia_pneumoniae	Chlamydia	Negative
AgProtect_1725	Chlamydia_pneumoniae	Chlamydia	Negative
AgProtect_1724	Chlamydia_pneumoniae	Chlamydia	Negative
AgProtect_1723	Chlamydia_pneumoniae	Chlamydia	Negative
AgProtect_1722	Mycobacterium_leprae	Mycobacterium	Positive_with_OM
AgProtect_1721	Chlamydia_trachomatis	Chlamydia	Negative
AgProtect_1720	Borreliella_burgdorferi	Borreliella	Negative
AgProtect_172	Francisella_tularensis	Francisella	Negative
AgProtect_1719	Borreliella_burgdorferi	Borreliella	Negative
AgProtect_1718	Borreliella_burgdorferi	Borreliella	Negative
AgProtect_1717	Borreliella_burgdorferi	Borreliella	Negative
AgProtect_1716	Brucella_melitensis	Brucella	Negative
AgProtect_1715	Mycobacterium_leprae	Mycobacterium	Positive_with_OM
AgProtect_1714	Mycobacterium_leprae	Mycobacterium	Positive_with_OM
AgProtect_1713	Mycobacterium_leprae	Mycobacterium	Positive_with_OM
AgProtect_1712	Mycobacterium_leprae	Mycobacterium	Positive_with_OM
AgProtect_1711	Mycobacterium_leprae	Mycobacterium	Positive_with_OM
AgProtect_1710	Mycobacterium_leprae	Mycobacterium	Positive_with_OM
AgProtect_171	Francisella_tularensis	Francisella	Negative
AgProtect_1709	Mycobacterium_leprae	Mycobacterium	Positive_with_OM
AgProtect_1708	Mycobacterium_leprae	Mycobacterium	Positive_with_OM
AgProtect_1707	Mycobacterium_leprae	Mycobacterium	Positive_with_OM
AgProtect_1706	Chlamydia_abortus	Chlamydia	Negative
AgProtect_1705	Streptococcus_pyogenes	Streptococcus	Positive
AgProtect_1705	Streptococcus_pyogenes	Streptococcus	Positive
AgProtect_1704	Brucella_melitensis	Brucella	Negative
AgProtect_1703	Brucella_melitensis	Brucella	Negative
AgProtect_1702	Brucella_melitensis	Brucella	Negative
AgProtect_1701	Brucella_melitensis	Brucella	Negative
AgProtect_1700	Brucella_melitensis	Brucella	Negative
AgProtect_170	Francisella_tularensis	Francisella	Negative
AgProtect_17	Chlamydia_muridarum	Chlamydia	Negative
AgProtect_1699	Brucella_melitensis	Brucella	Negative
AgProtect_1698	Brucella_melitensis	Brucella	Negative
AgProtect_1697	Brucella_melitensis	Brucella	Negative
AgProtect_1696	Brucella_melitensis	Brucella	Negative
AgProtect_1695	Listeria_monocytogenes	Listeria	Positive
AgProtect_1694	Leptospira_interrogans	Leptospira	Negative
AgProtect_1693	Leptospira_interrogans	Leptospira	Negative
AgProtect_1692	Leptospira_interrogans	Leptospira	Negative
AgProtect_1691	Leptospira_interrogans	Leptospira	Negative
AgProtect_1690	Streptococcus_agalactiae	Streptococcus	Positive
AgProtect_169	Francisella_tularensis	Francisella	Negative
AgProtect_1689	Streptococcus_pneumoniae	Streptococcus	Positive
AgProtect_1688	Streptococcus_pneumoniae	Streptococcus	Positive
AgProtect_1687	Streptococcus_pneumoniae	Streptococcus	Positive
AgProtect_1686	Streptococcus_pneumoniae	Streptococcus	Positive
AgProtect_1685	Streptococcus_pneumoniae	Streptococcus	Positive
AgProtect_1684	Coxiella_burnetii	Coxiella	Negative
AgProtect_1683	Coxiella_burnetii	Coxiella	Negative
AgProtect_1682	Coxiella_burnetii	Coxiella	Negative
AgProtect_1681	Coxiella_burnetii	Coxiella	Negative
AgProtect_1680	Coxiella_burnetii	Coxiella	Negative
AgProtect_168	Francisella_tularensis	Francisella	Negative
AgProtect_1679	Coxiella_burnetii	Coxiella	Negative
AgProtect_1678	Coxiella_burnetii	Coxiella	Negative
AgProtect_1677	Coxiella_burnetii	Coxiella	Negative
AgProtect_1676	Coxiella_burnetii	Coxiella	Negative
AgProtect_1675	Coxiella_burnetii	Coxiella	Negative
AgProtect_1674	Coxiella_burnetii	Coxiella	Negative
AgProtect_1673	Coxiella_burnetii	Coxiella	Negative
AgProtect_1672	Coxiella_burnetii	Coxiella	Negative
AgProtect_1671	Coxiella_burnetii	Coxiella	Negative
AgProtect_1670	Coxiella_burnetii	Coxiella	Negative
AgProtect_167	Chlamydophila_abortus	Chlamydophila	Negative
AgProtect_1669	Coxiella_burnetii	Coxiella	Negative
AgProtect_1668	Coxiella_burnetii	Coxiella	Negative
AgProtect_1667	Coxiella_burnetii	Coxiella	Negative
AgProtect_1666	Coxiella_burnetii	Coxiella	Negative
AgProtect_1665	Coxiella_burnetii	Coxiella	Negative
AgProtect_1664	Coxiella_burnetii	Coxiella	Negative
AgProtect_1663	Coxiella_burnetii	Coxiella	Negative
AgProtect_1662	Coxiella_burnetii	Coxiella	Negative
AgProtect_1661	Coxiella_burnetii	Coxiella	Negative
AgProtect_1660	Coxiella_burnetii	Coxiella	Negative
AgProtect_166	Chlamydophila_abortus	Chlamydophila	Negative
AgProtect_1659	Coxiella_burnetii	Coxiella	Negative
AgProtect_1658	Coxiella_burnetii	Coxiella	Negative
AgProtect_1657	Coxiella_burnetii	Coxiella	Negative
AgProtect_1656	Coxiella_burnetii	Coxiella	Negative
AgProtect_1655	Porphyromonas_gingivalis	Porphyromonas	Negative
AgProtect_1654	Mycobacterium_leprae	Mycobacterium	Positive_with_OM
AgProtect_1653	Mycobacterium_leprae	Mycobacterium	Positive_with_OM
AgProtect_1652	Mycobacterium_leprae	Mycobacterium	Positive_with_OM
AgProtect_1651	Mycobacterium_leprae	Mycobacterium	Positive_with_OM
AgProtect_1650	Mycobacterium_leprae	Mycobacterium	Positive_with_OM
AgProtect_165	Chlamydophila_abortus	Chlamydophila	Negative
AgProtect_1649	Mycobacterium_leprae	Mycobacterium	Positive_with_OM
AgProtect_1648	Mycobacterium_leprae	Mycobacterium	Positive_with_OM
AgProtect_1647	Mycobacterium_tuberculosis	Mycobacterium	Positive_with_OM
AgProtect_1646	Mycobacterium_tuberculosis	Mycobacterium	Positive_with_OM
AgProtect_1645	Mycobacterium_tuberculosis	Mycobacterium	Positive_with_OM
AgProtect_1644	Mycobacterium_tuberculosis	Mycobacterium	Positive_with_OM
AgProtect_1643	Mycobacterium_tuberculosis	Mycobacterium	Positive_with_OM
AgProtect_1642	Mycobacterium_tuberculosis	Mycobacterium	Positive_with_OM
AgProtect_1641	Mycobacterium_tuberculosis	Mycobacterium	Positive_with_OM
AgProtect_1640	Mycobacterium_tuberculosis	Mycobacterium	Positive_with_OM
AgProtect_164	Chlamydia_abortus	Chlamydia	Negative
AgProtect_1639	Mycobacterium_tuberculosis	Mycobacterium	Positive_with_OM
AgProtect_1638	Mycobacterium_tuberculosis	Mycobacterium	Positive_with_OM
AgProtect_1637	Mycobacterium_tuberculosis	Mycobacterium	Positive_with_OM
AgProtect_1636	Mycobacterium_tuberculosis	Mycobacterium	Positive_with_OM
AgProtect_1635	Mycobacterium_tuberculosis	Mycobacterium	Positive_with_OM
AgProtect_1634	Mycobacterium_tuberculosis	Mycobacterium	Positive_with_OM
AgProtect_1633	Mycobacterium_tuberculosis	Mycobacterium	Positive_with_OM
AgProtect_1632	Mycobacterium_tuberculosis	Mycobacterium	Positive_with_OM
AgProtect_1631	Mycobacterium_tuberculosis	Mycobacterium	Positive_with_OM
AgProtect_1630	Mycobacterium_tuberculosis	Mycobacterium	Positive_with_OM
AgProtect_163	Chlamydophila_abortus	Chlamydophila	Negative
AgProtect_1629	Mycobacterium_tuberculosis	Mycobacterium	Positive_with_OM
AgProtect_1628	Mycolicibacterium_paratuberculosis	Mycolicibacterium	Positive_with_OM
AgProtect_1627	Mycolicibacterium_paratuberculosis	Mycolicibacterium	Positive_with_OM
AgProtect_1626	Mycolicibacterium_paratuberculosis	Mycolicibacterium	Positive_with_OM
AgProtect_1625	Mycolicibacterium_paratuberculosis	Mycolicibacterium	Positive_with_OM
AgProtect_1624	Mycolicibacterium_paratuberculosis	Mycolicibacterium	Positive_with_OM
AgProtect_1623	Mycolicibacterium_paratuberculosis	Mycolicibacterium	Positive_with_OM
AgProtect_1622	Mycolicibacterium_paratuberculosis	Mycolicibacterium	Positive_with_OM
AgProtect_1621	Mycolicibacterium_paratuberculosis	Mycolicibacterium	Positive_with_OM
AgProtect_1620	Mycolicibacterium_paratuberculosis	Mycolicibacterium	Positive_with_OM
AgProtect_162	Chlamydia_abortus	Chlamydia	Negative
AgProtect_1619	Mycolicibacterium_paratuberculosis	Mycolicibacterium	Positive_with_OM
AgProtect_1618	Mycobacterium_tuberculosis	Mycobacterium	Positive_with_OM
AgProtect_1617	Mycobacterium_tuberculosis	Mycobacterium	Positive_with_OM
AgProtect_1616	Mycobacterium_tuberculosis	Mycobacterium	Positive_with_OM
AgProtect_1615	Mycobacterium_tuberculosis	Mycobacterium	Positive_with_OM
AgProtect_1614	Mycobacterium_tuberculosis	Mycobacterium	Positive_with_OM
AgProtect_1613	Mycobacterium_tuberculosis	Mycobacterium	Positive_with_OM
AgProtect_1612	Burkholderia_pseudomallei	Burkholderia	Negative
AgProtect_1611	Burkholderia_pseudomallei	Burkholderia	Negative
AgProtect_1610	Francisella_tularensis	Francisella	Negative
AgProtect_161	Campylobacter_jejuni	Campylobacter	Negative
AgProtect_1609	Francisella_tularensis	Francisella	Negative
AgProtect_1608	Francisella_tularensis	Francisella	Negative
AgProtect_1607	Francisella_tularensis	Francisella	Negative
AgProtect_1606	Francisella_tularensis	Francisella	Negative
AgProtect_1605	Francisella_tularensis	Francisella	Negative
AgProtect_1604	Francisella_tularensis	Francisella	Negative
AgProtect_1603	Francisella_tularensis	Francisella	Negative
AgProtect_1602	Francisella_tularensis	Francisella	Negative
AgProtect_1601	Francisella_tularensis	Francisella	Negative
AgProtect_1600	Francisella_tularensis	Francisella	Negative
AgProtect_160	Campylobacter_jejuni	Campylobacter	Negative
AgProtect_16	Chlamydia_muridarum	Chlamydia	Negative
AgProtect_1599	Francisella_tularensis	Francisella	Negative
AgProtect_1598	Francisella_tularensis	Francisella	Negative
AgProtect_1597	Francisella_tularensis	Francisella	Negative
AgProtect_1596	Francisella_tularensis	Francisella	Negative
AgProtect_1595	Francisella_tularensis	Francisella	Negative
AgProtect_1594	Francisella_tularensis	Francisella	Negative
AgProtect_1593	Francisella_tularensis	Francisella	Negative
AgProtect_1592	Francisella_tularensis	Francisella	Negative
AgProtect_1591	Francisella_tularensis	Francisella	Negative
AgProtect_1590	Francisella_tularensis	Francisella	Negative
AgProtect_159	Campylobacter_jejuni	Campylobacter	Negative
AgProtect_1589	Francisella_tularensis	Francisella	Negative
AgProtect_1588	Francisella_tularensis	Francisella	Negative
AgProtect_1587	Francisella_tularensis	Francisella	Negative
AgProtect_1586	Francisella_tularensis	Francisella	Negative
AgProtect_1585	Francisella_tularensis	Francisella	Negative
AgProtect_1584	Francisella_tularensis	Francisella	Negative
AgProtect_1583	Francisella_tularensis	Francisella	Negative
AgProtect_1582	Francisella_tularensis	Francisella	Negative
AgProtect_1581	Francisella_tularensis	Francisella	Negative
AgProtect_1580	Francisella_tularensis	Francisella	Negative
AgProtect_158	Campylobacter_jejuni	Campylobacter	Negative
AgProtect_1579	Francisella_tularensis	Francisella	Negative
AgProtect_1578	Francisella_tularensis	Francisella	Negative
AgProtect_1577	Francisella_tularensis	Francisella	Negative
AgProtect_1576	Francisella_tularensis	Francisella	Negative
AgProtect_1575	Francisella_tularensis	Francisella	Negative
AgProtect_1574	Chlamydia_abortus	Chlamydia	Negative
AgProtect_1573	Streptococcus_pneumoniae	Streptococcus	Positive
AgProtect_1572	Borreliella_burgdorferi	Borreliella	Negative
AgProtect_1571	Mycobacterium_tuberculosis	Mycobacterium	Positive_with_OM
AgProtect_1570	Mycobacterium_tuberculosis	Mycobacterium	Positive_with_OM
AgProtect_157	Campylobacter_jejuni	Campylobacter	Negative
AgProtect_1569	Mycobacterium_tuberculosis	Mycobacterium	Positive_with_OM
AgProtect_1568	Mycobacterium_tuberculosis	Mycobacterium	Positive_with_OM
AgProtect_1567	Mesomycoplasma_hyopneumoniae	Mesomycoplasma	Negative_without_OM
AgProtect_1566	Mesomycoplasma_hyopneumoniae	Mesomycoplasma	Negative_without_OM
AgProtect_1565	Mesomycoplasma_hyopneumoniae	Mesomycoplasma	Negative_without_OM
AgProtect_1564	Mesomycoplasma_hyopneumoniae	Mesomycoplasma	Negative_without_OM
AgProtect_1563	Mesomycoplasma_hyopneumoniae	Mesomycoplasma	Negative_without_OM
AgProtect_1562	Mesomycoplasma_hyopneumoniae	Mesomycoplasma	Negative_without_OM
AgProtect_1561	Mycobacterium_leprae	Mycobacterium	Positive_with_OM
AgProtect_1560	Mycobacterium_leprae	Mycobacterium	Positive_with_OM
AgProtect_156	Campylobacter_jejuni	Campylobacter	Negative
AgProtect_1559	Borreliella_burgdorferi	Borreliella	Negative
AgProtect_1558	Ehrlichia_canis	Ehrlichia	Negative
AgProtect_1557	Enterococcus_faecium	Enterococcus	Positive
AgProtect_1556	Anaplasma_phagocytophilum	Anaplasma	Negative
AgProtect_1555	Anaplasma_phagocytophilum	Anaplasma	Negative
AgProtect_1554	Ehrlichia_chaffeensis	Ehrlichia	Negative
AgProtect_1553	Ehrlichia_chaffeensis	Ehrlichia	Negative
AgProtect_1552	Ehrlichia_chaffeensis	Ehrlichia	Negative
AgProtect_1551	Staphylococcus_aureus	Staphylococcus	Positive
AgProtect_1550	Staphylococcus_aureus	Staphylococcus	Positive
AgProtect_155	Bordetella_pertussis	Bordetella	Negative
AgProtect_1549	Staphylococcus_aureus	Staphylococcus	Positive
AgProtect_1548	Staphylococcus_aureus	Staphylococcus	Positive
AgProtect_1547	Staphylococcus_aureus	Staphylococcus	Positive
AgProtect_1546	Staphylococcus_aureus	Staphylococcus	Positive
AgProtect_1545	Staphylococcus_aureus	Staphylococcus	Positive
AgProtect_1544	Staphylococcus_aureus	Staphylococcus	Positive
AgProtect_1543	Staphylococcus_aureus	Staphylococcus	Positive
AgProtect_1542	Staphylococcus_aureus	Staphylococcus	Positive
AgProtect_1541	Staphylococcus_aureus	Staphylococcus	Positive
AgProtect_1540	Staphylococcus_aureus	Staphylococcus	Positive
AgProtect_154	Bordetella_pertussis	Bordetella	Negative
AgProtect_1539	Staphylococcus_aureus	Staphylococcus	Positive
AgProtect_1538	Staphylococcus_aureus	Staphylococcus	Positive
AgProtect_1537	Staphylococcus_aureus	Staphylococcus	Positive
AgProtect_1536	Staphylococcus_aureus	Staphylococcus	Positive
AgProtect_1535	Staphylococcus_aureus	Staphylococcus	Positive
AgProtect_1534	Staphylococcus_aureus	Staphylococcus	Positive
AgProtect_1533	Staphylococcus_aureus	Staphylococcus	Positive
AgProtect_1532	Staphylococcus_aureus	Staphylococcus	Positive
AgProtect_1531	Chlamydia_felis	Chlamydia	Negative
AgProtect_1530	Clostridioides_difficile	Clostridioides	Positive
AgProtect_153	Bordetella_pertussis	Bordetella	Negative
AgProtect_1529	Clostridioides_difficile	Clostridioides	Positive
AgProtect_1528	Clostridioides_difficile	Clostridioides	Positive
AgProtect_1527	Clostridioides_difficile	Clostridioides	Positive
AgProtect_1526	Clostridioides_difficile	Clostridioides	Positive
AgProtect_1525	Mycobacterium_tuberculosis	Mycobacterium	Positive_with_OM
AgProtect_1524	Mycobacterium_tuberculosis	Mycobacterium	Positive_with_OM
AgProtect_1523	Borreliella_afzelii	Borreliella	Negative
AgProtect_1522	Mycobacterium_tuberculosis	Mycobacterium	Positive_with_OM
AgProtect_1521	Mycobacterium_tuberculosis	Mycobacterium	Positive_with_OM
AgProtect_1520	Mycobacterium_tuberculosis	Mycobacterium	Positive_with_OM
AgProtect_152	Bordetella_pertussis	Bordetella	Negative
AgProtect_1519	Mycobacterium_tuberculosis	Mycobacterium	Positive_with_OM
AgProtect_1518	Mycobacterium_tuberculosis	Mycobacterium	Positive_with_OM
AgProtect_1517	Mycobacterium_tuberculosis	Mycobacterium	Positive_with_OM
AgProtect_1516	Mycobacterium_tuberculosis	Mycobacterium	Positive_with_OM
AgProtect_1515	Mycobacterium_tuberculosis	Mycobacterium	Positive_with_OM
AgProtect_1514	Mycobacterium_tuberculosis	Mycobacterium	Positive_with_OM
AgProtect_1513	Mycobacterium_tuberculosis	Mycobacterium	Positive_with_OM
AgProtect_1512	Mycobacterium_tuberculosis	Mycobacterium	Positive_with_OM
AgProtect_1511	Mycobacterium_tuberculosis	Mycobacterium	Positive_with_OM
AgProtect_1510	Mycobacterium_tuberculosis	Mycobacterium	Positive_with_OM
AgProtect_151	Bordetella_pertussis	Bordetella	Negative
AgProtect_1509	Mycobacterium_tuberculosis	Mycobacterium	Positive_with_OM
AgProtect_1508	Mycobacterium_tuberculosis	Mycobacterium	Positive_with_OM
AgProtect_1507	Mycobacterium_tuberculosis	Mycobacterium	Positive_with_OM
AgProtect_1506	Mycobacterium_tuberculosis	Mycobacterium	Positive_with_OM
AgProtect_1505	Mycobacterium_tuberculosis	Mycobacterium	Positive_with_OM
AgProtect_1504	Mycobacterium_tuberculosis	Mycobacterium	Positive_with_OM
AgProtect_1503	Mycobacterium_tuberculosis	Mycobacterium	Positive_with_OM
AgProtect_1502	Mycobacterium_tuberculosis	Mycobacterium	Positive_with_OM
AgProtect_1501	Mycobacterium_tuberculosis	Mycobacterium	Positive_with_OM
AgProtect_1500	Mycobacterium_tuberculosis	Mycobacterium	Positive_with_OM
AgProtect_150	Bordetella_pertussis	Bordetella	Negative
AgProtect_15	Chlamydia_muridarum	Chlamydia	Negative
AgProtect_1499	Mycobacterium_tuberculosis	Mycobacterium	Positive_with_OM
AgProtect_1498	Mycobacterium_tuberculosis	Mycobacterium	Positive_with_OM
AgProtect_1497	Mycobacterium_tuberculosis	Mycobacterium	Positive_with_OM
AgProtect_1496	Mycobacterium_tuberculosis	Mycobacterium	Positive_with_OM
AgProtect_1495	Mycobacterium_tuberculosis	Mycobacterium	Positive_with_OM
AgProtect_1494	Mycobacterium_tuberculosis	Mycobacterium	Positive_with_OM
AgProtect_1493	Mycobacterium_tuberculosis	Mycobacterium	Positive_with_OM
AgProtect_1492	Mycobacterium_tuberculosis	Mycobacterium	Positive_with_OM
AgProtect_1491	Mycobacterium_tuberculosis	Mycobacterium	Positive_with_OM
AgProtect_1490	Mycobacterium_tuberculosis	Mycobacterium	Positive_with_OM
AgProtect_149	Bordetella_pertussis	Bordetella	Negative
AgProtect_1489	Mycobacterium_tuberculosis	Mycobacterium	Positive_with_OM
AgProtect_1488	Mycobacterium_tuberculosis	Mycobacterium	Positive_with_OM
AgProtect_1487	Mycobacterium_tuberculosis	Mycobacterium	Positive_with_OM
AgProtect_1486	Mycobacterium_tuberculosis	Mycobacterium	Positive_with_OM
AgProtect_1485	Mycobacterium_tuberculosis	Mycobacterium	Positive_with_OM
AgProtect_1484	Mycobacterium_tuberculosis	Mycobacterium	Positive_with_OM
AgProtect_1483	Mycobacterium_tuberculosis	Mycobacterium	Positive_with_OM
AgProtect_1482	Mycobacterium_tuberculosis	Mycobacterium	Positive_with_OM
AgProtect_1481	Mycobacterium_tuberculosis	Mycobacterium	Positive_with_OM
AgProtect_1480	Mycobacterium_tuberculosis	Mycobacterium	Positive_with_OM
AgProtect_148	Bordetella_pertussis	Bordetella	Negative
AgProtect_1479	Mycobacterium_tuberculosis	Mycobacterium	Positive_with_OM
AgProtect_1478	Mycobacterium_tuberculosis	Mycobacterium	Positive_with_OM
AgProtect_1477	Mycobacterium_tuberculosis	Mycobacterium	Positive_with_OM
AgProtect_1476	Mycobacterium_tuberculosis	Mycobacterium	Positive_with_OM
AgProtect_1475	Mycobacterium_tuberculosis	Mycobacterium	Positive_with_OM
AgProtect_1474	Mycobacterium_tuberculosis	Mycobacterium	Positive_with_OM
AgProtect_1473	Mycobacterium_tuberculosis	Mycobacterium	Positive_with_OM
AgProtect_1472	Mycobacterium_tuberculosis	Mycobacterium	Positive_with_OM
AgProtect_1471	Mycobacterium_tuberculosis	Mycobacterium	Positive_with_OM
AgProtect_1470	Mycobacterium_tuberculosis	Mycobacterium	Positive_with_OM
AgProtect_147	Bordetella_pertussis	Bordetella	Negative
AgProtect_1469	Mycobacterium_tuberculosis	Mycobacterium	Positive_with_OM
AgProtect_1468	Mycobacterium_tuberculosis	Mycobacterium	Positive_with_OM
AgProtect_1467	Mycobacterium_tuberculosis	Mycobacterium	Positive_with_OM
AgProtect_1466	Mycobacterium_tuberculosis	Mycobacterium	Positive_with_OM
AgProtect_1465	Mycobacterium_tuberculosis	Mycobacterium	Positive_with_OM
AgProtect_1464	Mycobacterium_tuberculosis	Mycobacterium	Positive_with_OM
AgProtect_1463	Mycobacterium_tuberculosis	Mycobacterium	Positive_with_OM
AgProtect_1462	Mycobacterium_tuberculosis	Mycobacterium	Positive_with_OM
AgProtect_1461	Mycobacterium_tuberculosis	Mycobacterium	Positive_with_OM
AgProtect_1460	Mycobacterium_tuberculosis	Mycobacterium	Positive_with_OM
AgProtect_146	Bordetella_pertussis	Bordetella	Negative
AgProtect_1459	Mycobacterium_tuberculosis	Mycobacterium	Positive_with_OM
AgProtect_1458	Mycobacterium_tuberculosis	Mycobacterium	Positive_with_OM
AgProtect_1457	Mycobacterium_tuberculosis	Mycobacterium	Positive_with_OM
AgProtect_1456	Mycobacterium_tuberculosis	Mycobacterium	Positive_with_OM
AgProtect_1455	Mycobacterium_tuberculosis	Mycobacterium	Positive_with_OM
AgProtect_1454	Mycobacterium_tuberculosis	Mycobacterium	Positive_with_OM
AgProtect_1453	Mycobacterium_tuberculosis	Mycobacterium	Positive_with_OM
AgProtect_1452	Mycobacterium_tuberculosis	Mycobacterium	Positive_with_OM
AgProtect_1451	Mycobacterium_tuberculosis	Mycobacterium	Positive_with_OM
AgProtect_1450	Mycobacterium_tuberculosis	Mycobacterium	Positive_with_OM
AgProtect_145	Bacillus_anthracis	Bacillus	Positive
AgProtect_1449	Mycobacterium_tuberculosis	Mycobacterium	Positive_with_OM
AgProtect_1448	Mycobacterium_tuberculosis	Mycobacterium	Positive_with_OM
AgProtect_1447	Mycobacterium_tuberculosis	Mycobacterium	Positive_with_OM
AgProtect_1446	Mycobacterium_tuberculosis	Mycobacterium	Positive_with_OM
AgProtect_1445	Mycobacterium_tuberculosis	Mycobacterium	Positive_with_OM
AgProtect_1444	Mycobacterium_tuberculosis	Mycobacterium	Positive_with_OM
AgProtect_1443	Mycobacterium_tuberculosis	Mycobacterium	Positive_with_OM
AgProtect_1442	Mycobacterium_tuberculosis	Mycobacterium	Positive_with_OM
AgProtect_1441	Mycobacterium_tuberculosis	Mycobacterium	Positive_with_OM
AgProtect_1440	Mycobacterium_tuberculosis	Mycobacterium	Positive_with_OM
AgProtect_144	Aeromonas_salmonicida	Aeromonas	Negative
AgProtect_1439	Mycobacterium_tuberculosis	Mycobacterium	Positive_with_OM
AgProtect_1438	Mycobacterium_tuberculosis	Mycobacterium	Positive_with_OM
AgProtect_1437	Mycobacterium_tuberculosis	Mycobacterium	Positive_with_OM
AgProtect_1436	Mycobacterium_tuberculosis	Mycobacterium	Positive_with_OM
AgProtect_1435	Mycobacterium_tuberculosis	Mycobacterium	Positive_with_OM
AgProtect_1434	Mycobacterium_tuberculosis	Mycobacterium	Positive_with_OM
AgProtect_1433	Mycobacterium_tuberculosis	Mycobacterium	Positive_with_OM
AgProtect_1432	Mycobacterium_tuberculosis	Mycobacterium	Positive_with_OM
AgProtect_1431	Mycobacterium_tuberculosis	Mycobacterium	Positive_with_OM
AgProtect_1430	Mycobacterium_tuberculosis	Mycobacterium	Positive_with_OM
AgProtect_143	Aeromonas_salmonicida	Aeromonas	Negative
AgProtect_1429	Mycobacterium_tuberculosis	Mycobacterium	Positive_with_OM
AgProtect_1428	Mycobacterium_tuberculosis	Mycobacterium	Positive_with_OM
AgProtect_1427	Mycobacterium_tuberculosis	Mycobacterium	Positive_with_OM
AgProtect_1426	Mycobacterium_tuberculosis	Mycobacterium	Positive_with_OM
AgProtect_1425	Mycobacterium_tuberculosis	Mycobacterium	Positive_with_OM
AgProtect_1424	Mycobacterium_tuberculosis	Mycobacterium	Positive_with_OM
AgProtect_1423	Mycobacterium_tuberculosis	Mycobacterium	Positive_with_OM
AgProtect_1422	Mycobacterium_tuberculosis	Mycobacterium	Positive_with_OM
AgProtect_1421	Mycobacterium_tuberculosis	Mycobacterium	Positive_with_OM
AgProtect_1420	Mycobacterium_tuberculosis	Mycobacterium	Positive_with_OM
AgProtect_142	Actinobacillus_pleuropneumoniae	Actinobacillus	Negative
AgProtect_1419	Mycobacterium_tuberculosis	Mycobacterium	Positive_with_OM
AgProtect_1418	Mycobacterium_tuberculosis	Mycobacterium	Positive_with_OM
AgProtect_1417	Mycobacterium_tuberculosis	Mycobacterium	Positive_with_OM
AgProtect_1416	Mycobacterium_tuberculosis	Mycobacterium	Positive_with_OM
AgProtect_1415	Mycobacterium_tuberculosis	Mycobacterium	Positive_with_OM
AgProtect_1414	Mycobacterium_tuberculosis	Mycobacterium	Positive_with_OM
AgProtect_1413	Mycobacterium_tuberculosis	Mycobacterium	Positive_with_OM
AgProtect_1412	Mycobacterium_tuberculosis	Mycobacterium	Positive_with_OM
AgProtect_1411	Mycobacterium_tuberculosis	Mycobacterium	Positive_with_OM
AgProtect_1410	Mycobacterium_tuberculosis	Mycobacterium	Positive_with_OM
AgProtect_141	Actinobacillus_pleuropneumoniae	Actinobacillus	Negative
AgProtect_1409	Mycobacterium_tuberculosis	Mycobacterium	Positive_with_OM
AgProtect_1408	Mycobacterium_tuberculosis	Mycobacterium	Positive_with_OM
AgProtect_1407	Mycobacterium_tuberculosis	Mycobacterium	Positive_with_OM
AgProtect_1406	Mycobacterium_tuberculosis	Mycobacterium	Positive_with_OM
AgProtect_1405	Mycobacterium_tuberculosis	Mycobacterium	Positive_with_OM
AgProtect_1404	Mycobacterium_tuberculosis	Mycobacterium	Positive_with_OM
AgProtect_1403	Mycobacterium_tuberculosis	Mycobacterium	Positive_with_OM
AgProtect_1402	Mycobacterium_tuberculosis	Mycobacterium	Positive_with_OM
AgProtect_1401	Mycobacterium_tuberculosis	Mycobacterium	Positive_with_OM
AgProtect_1400	Mycobacterium_tuberculosis	Mycobacterium	Positive_with_OM
AgProtect_140	Actinobacillus_pleuropneumoniae	Actinobacillus	Negative
AgProtect_14	Chlamydia_pneumoniae	Chlamydia	Negative
AgProtect_1399	Mycobacterium_tuberculosis	Mycobacterium	Positive_with_OM
AgProtect_1398	Mycobacterium_tuberculosis	Mycobacterium	Positive_with_OM
AgProtect_1397	Mycobacterium_tuberculosis	Mycobacterium	Positive_with_OM
AgProtect_1396	Mycobacterium_tuberculosis	Mycobacterium	Positive_with_OM
AgProtect_1395	Mycobacterium_tuberculosis	Mycobacterium	Positive_with_OM
AgProtect_1394	Mycobacterium_tuberculosis	Mycobacterium	Positive_with_OM
AgProtect_1393	Mycobacterium_tuberculosis	Mycobacterium	Positive_with_OM
AgProtect_1392	Mycobacterium_tuberculosis	Mycobacterium	Positive_with_OM
AgProtect_1391	Mycobacterium_tuberculosis	Mycobacterium	Positive_with_OM
AgProtect_1390	Mycobacterium_tuberculosis	Mycobacterium	Positive_with_OM
AgProtect_139	Yersinia_pseudotuberculosis	Yersinia	Negative
AgProtect_1389	Mycobacterium_tuberculosis	Mycobacterium	Positive_with_OM
AgProtect_1388	Mycobacterium_tuberculosis	Mycobacterium	Positive_with_OM
AgProtect_1387	Mycobacterium_tuberculosis	Mycobacterium	Positive_with_OM
AgProtect_1386	Mycobacterium_tuberculosis	Mycobacterium	Positive_with_OM
AgProtect_1385	Mycobacterium_tuberculosis	Mycobacterium	Positive_with_OM
AgProtect_1384	Mycobacterium_tuberculosis	Mycobacterium	Positive_with_OM
AgProtect_1383	Mycobacterium_tuberculosis	Mycobacterium	Positive_with_OM
AgProtect_1382	Mycobacterium_tuberculosis	Mycobacterium	Positive_with_OM
AgProtect_1381	Mycobacterium_tuberculosis	Mycobacterium	Positive_with_OM
AgProtect_1380	Mycobacterium_tuberculosis	Mycobacterium	Positive_with_OM
AgProtect_138	Yersinia_pestis	Yersinia	Negative
AgProtect_1379	Mycobacterium_tuberculosis	Mycobacterium	Positive_with_OM
AgProtect_1378	Mycobacterium_tuberculosis	Mycobacterium	Positive_with_OM
AgProtect_1377	Mycobacterium_tuberculosis	Mycobacterium	Positive_with_OM
AgProtect_1376	Mycobacterium_tuberculosis	Mycobacterium	Positive_with_OM
AgProtect_1375	Mycobacterium_tuberculosis	Mycobacterium	Positive_with_OM
AgProtect_1374	Mycobacterium_tuberculosis	Mycobacterium	Positive_with_OM
AgProtect_1373	Mycobacterium_tuberculosis	Mycobacterium	Positive_with_OM
AgProtect_1372	Mycobacterium_tuberculosis	Mycobacterium	Positive_with_OM
AgProtect_1371	Mycobacterium_tuberculosis	Mycobacterium	Positive_with_OM
AgProtect_1370	Mycobacterium_tuberculosis	Mycobacterium	Positive_with_OM
AgProtect_137	Yersinia_pestis	Yersinia	Negative
AgProtect_1369	Mycobacterium_tuberculosis	Mycobacterium	Positive_with_OM
AgProtect_1368	Mycobacterium_tuberculosis	Mycobacterium	Positive_with_OM
AgProtect_1367	Mycobacterium_tuberculosis	Mycobacterium	Positive_with_OM
AgProtect_1366	Mycobacterium_tuberculosis	Mycobacterium	Positive_with_OM
AgProtect_1365	Mycobacterium_tuberculosis	Mycobacterium	Positive_with_OM
AgProtect_1364	Mycobacterium_tuberculosis	Mycobacterium	Positive_with_OM
AgProtect_1363	Mycobacterium_tuberculosis	Mycobacterium	Positive_with_OM
AgProtect_1362	Mycobacterium_tuberculosis	Mycobacterium	Positive_with_OM
AgProtect_1361	Mycobacterium_tuberculosis	Mycobacterium	Positive_with_OM
AgProtect_1360	Mycobacterium_tuberculosis	Mycobacterium	Positive_with_OM
AgProtect_136	Yersinia_pestis	Yersinia	Negative
AgProtect_1359	Mycobacterium_tuberculosis	Mycobacterium	Positive_with_OM
AgProtect_1358	Mycobacterium_tuberculosis	Mycobacterium	Positive_with_OM
AgProtect_1357	Mycobacterium_tuberculosis	Mycobacterium	Positive_with_OM
AgProtect_1356	Mycobacterium_tuberculosis	Mycobacterium	Positive_with_OM
AgProtect_1355	Mycobacterium_tuberculosis	Mycobacterium	Positive_with_OM
AgProtect_1354	Mycobacterium_tuberculosis	Mycobacterium	Positive_with_OM
AgProtect_1353	Mycobacterium_tuberculosis	Mycobacterium	Positive_with_OM
AgProtect_1352	Mycobacterium_tuberculosis	Mycobacterium	Positive_with_OM
AgProtect_1351	Mycobacterium_tuberculosis	Mycobacterium	Positive_with_OM
AgProtect_1350	Mycobacterium_tuberculosis	Mycobacterium	Positive_with_OM
AgProtect_135	Yersinia_pestis	Yersinia	Negative
AgProtect_1349	Mycobacterium_tuberculosis	Mycobacterium	Positive_with_OM
AgProtect_1348	Mycobacterium_tuberculosis	Mycobacterium	Positive_with_OM
AgProtect_1347	Mycobacterium_tuberculosis	Mycobacterium	Positive_with_OM
AgProtect_1346	Mycobacterium_tuberculosis	Mycobacterium	Positive_with_OM
AgProtect_1345	Mycobacterium_tuberculosis	Mycobacterium	Positive_with_OM
AgProtect_1344	Mycobacterium_tuberculosis	Mycobacterium	Positive_with_OM
AgProtect_1343	Mycobacterium_tuberculosis	Mycobacterium	Positive_with_OM
AgProtect_1342	Mycobacterium_tuberculosis	Mycobacterium	Positive_with_OM
AgProtect_1341	Mycobacterium_tuberculosis	Mycobacterium	Positive_with_OM
AgProtect_1340	Mycobacterium_tuberculosis	Mycobacterium	Positive_with_OM
AgProtect_134	Yersinia_pestis	Yersinia	Negative
AgProtect_1339	Mycobacterium_tuberculosis	Mycobacterium	Positive_with_OM
AgProtect_1338	Mycobacterium_tuberculosis	Mycobacterium	Positive_with_OM
AgProtect_1337	Mycobacterium_tuberculosis	Mycobacterium	Positive_with_OM
AgProtect_1336	Mycobacterium_tuberculosis	Mycobacterium	Positive_with_OM
AgProtect_1335	Mycobacterium_tuberculosis	Mycobacterium	Positive_with_OM
AgProtect_1334	Mycobacterium_tuberculosis	Mycobacterium	Positive_with_OM
AgProtect_1333	Mycobacterium_tuberculosis	Mycobacterium	Positive_with_OM
AgProtect_1332	Mycobacterium_tuberculosis	Mycobacterium	Positive_with_OM
AgProtect_1331	Mycobacterium_tuberculosis	Mycobacterium	Positive_with_OM
AgProtect_1330	Mycobacterium_tuberculosis	Mycobacterium	Positive_with_OM
AgProtect_133	Yersinia_pestis	Yersinia	Negative
AgProtect_1329	Mycobacterium_tuberculosis	Mycobacterium	Positive_with_OM
AgProtect_1328	Mycobacterium_tuberculosis	Mycobacterium	Positive_with_OM
AgProtect_1327	Mycobacterium_tuberculosis	Mycobacterium	Positive_with_OM
AgProtect_1326	Mycobacterium_tuberculosis	Mycobacterium	Positive_with_OM
AgProtect_1325	Mycobacterium_tuberculosis	Mycobacterium	Positive_with_OM
AgProtect_1324	Mycobacterium_tuberculosis	Mycobacterium	Positive_with_OM
AgProtect_1323	Mycobacterium_tuberculosis	Mycobacterium	Positive_with_OM
AgProtect_1322	Mycobacterium_tuberculosis	Mycobacterium	Positive_with_OM
AgProtect_1321	Mycobacterium_tuberculosis	Mycobacterium	Positive_with_OM
AgProtect_1320	Mycobacterium_tuberculosis	Mycobacterium	Positive_with_OM
AgProtect_132	Yersinia_pestis	Yersinia	Negative
AgProtect_1319	Mycobacterium_tuberculosis	Mycobacterium	Positive_with_OM
AgProtect_1318	Mycobacterium_tuberculosis	Mycobacterium	Positive_with_OM
AgProtect_1317	Mycobacterium_tuberculosis	Mycobacterium	Positive_with_OM
AgProtect_1316	Mycobacterium_tuberculosis	Mycobacterium	Positive_with_OM
AgProtect_1315	Mycobacterium_tuberculosis	Mycobacterium	Positive_with_OM
AgProtect_1314	Mycobacterium_tuberculosis	Mycobacterium	Positive_with_OM
AgProtect_1313	Mycobacterium_tuberculosis	Mycobacterium	Positive_with_OM
AgProtect_1312	Mycobacterium_tuberculosis	Mycobacterium	Positive_with_OM
AgProtect_1311	Mycobacterium_tuberculosis	Mycobacterium	Positive_with_OM
AgProtect_1310	Mycobacterium_tuberculosis	Mycobacterium	Positive_with_OM
AgProtect_131	Yersinia_pestis	Yersinia	Negative
AgProtect_1309	Mycobacterium_tuberculosis	Mycobacterium	Positive_with_OM
AgProtect_1308	Mycobacterium_tuberculosis	Mycobacterium	Positive_with_OM
AgProtect_1307	Mycobacterium_tuberculosis	Mycobacterium	Positive_with_OM
AgProtect_1306	Mycobacterium_tuberculosis	Mycobacterium	Positive_with_OM
AgProtect_1305	Mycobacterium_tuberculosis	Mycobacterium	Positive_with_OM
AgProtect_1304	Mycobacterium_tuberculosis	Mycobacterium	Positive_with_OM
AgProtect_1303	Mycobacterium_tuberculosis	Mycobacterium	Positive_with_OM
AgProtect_1302	Mycobacterium_tuberculosis	Mycobacterium	Positive_with_OM
AgProtect_1301	Mycobacterium_tuberculosis	Mycobacterium	Positive_with_OM
AgProtect_1300	Mycobacterium_tuberculosis	Mycobacterium	Positive_with_OM
AgProtect_130	Yersinia_pestis	Yersinia	Negative
AgProtect_13	Chlamydia_abortus	Chlamydia	Negative
AgProtect_1299	Mycobacterium_tuberculosis	Mycobacterium	Positive_with_OM
AgProtect_1298	Mycobacterium_tuberculosis	Mycobacterium	Positive_with_OM
AgProtect_1297	Mycobacterium_tuberculosis	Mycobacterium	Positive_with_OM
AgProtect_1296	Mycobacterium_tuberculosis	Mycobacterium	Positive_with_OM
AgProtect_1295	Mycobacterium_tuberculosis	Mycobacterium	Positive_with_OM
AgProtect_1294	Mycobacterium_tuberculosis	Mycobacterium	Positive_with_OM
AgProtect_1293	Mycobacterium_tuberculosis	Mycobacterium	Positive_with_OM
AgProtect_1292	Mycobacterium_tuberculosis	Mycobacterium	Positive_with_OM
AgProtect_1291	Mycobacterium_tuberculosis	Mycobacterium	Positive_with_OM
AgProtect_1290	Mycobacterium_tuberculosis	Mycobacterium	Positive_with_OM
AgProtect_129	Yersinia_pestis	Yersinia	Negative
AgProtect_1289	Mycobacterium_tuberculosis	Mycobacterium	Positive_with_OM
AgProtect_1288	Mycobacterium_tuberculosis	Mycobacterium	Positive_with_OM
AgProtect_1287	Mycobacterium_tuberculosis	Mycobacterium	Positive_with_OM
AgProtect_1286	Mycobacterium_tuberculosis	Mycobacterium	Positive_with_OM
AgProtect_1285	Mycobacterium_tuberculosis	Mycobacterium	Positive_with_OM
AgProtect_1284	Mycobacterium_tuberculosis	Mycobacterium	Positive_with_OM
AgProtect_1283	Mycobacterium_tuberculosis	Mycobacterium	Positive_with_OM
AgProtect_1282	Mycobacterium_tuberculosis	Mycobacterium	Positive_with_OM
AgProtect_1281	Mycobacterium_tuberculosis	Mycobacterium	Positive_with_OM
AgProtect_1280	Mycobacterium_tuberculosis	Mycobacterium	Positive_with_OM
AgProtect_128	Yersinia_pestis	Yersinia	Negative
AgProtect_1279	Mycobacterium_tuberculosis	Mycobacterium	Positive_with_OM
AgProtect_1278	Mycobacterium_tuberculosis	Mycobacterium	Positive_with_OM
AgProtect_1277	Mycobacterium_tuberculosis	Mycobacterium	Positive_with_OM
AgProtect_1276	Mycobacterium_tuberculosis	Mycobacterium	Positive_with_OM
AgProtect_1275	Mycobacterium_tuberculosis	Mycobacterium	Positive_with_OM
AgProtect_1274	Mycobacterium_tuberculosis	Mycobacterium	Positive_with_OM
AgProtect_1273	Mycobacterium_tuberculosis	Mycobacterium	Positive_with_OM
AgProtect_1272	Mycobacterium_tuberculosis	Mycobacterium	Positive_with_OM
AgProtect_1271	Mycobacterium_tuberculosis	Mycobacterium	Positive_with_OM
AgProtect_1270	Mycobacterium_tuberculosis	Mycobacterium	Positive_with_OM
AgProtect_127	Salmonella_enterica_serovar_Typhimurium	Salmonella	Negative
AgProtect_1269	Mycobacterium_tuberculosis	Mycobacterium	Positive_with_OM
AgProtect_1268	Mycobacterium_tuberculosis	Mycobacterium	Positive_with_OM
AgProtect_1267	Mycobacterium_tuberculosis	Mycobacterium	Positive_with_OM
AgProtect_1266	Mycobacterium_tuberculosis	Mycobacterium	Positive_with_OM
AgProtect_1265	Mycobacterium_tuberculosis	Mycobacterium	Positive_with_OM
AgProtect_1264	Mycobacterium_tuberculosis	Mycobacterium	Positive_with_OM
AgProtect_1263	Mycobacterium_tuberculosis	Mycobacterium	Positive_with_OM
AgProtect_1262	Mycobacterium_tuberculosis	Mycobacterium	Positive_with_OM
AgProtect_1261	Mycobacterium_tuberculosis	Mycobacterium	Positive_with_OM
AgProtect_1260	Mycobacterium_tuberculosis	Mycobacterium	Positive_with_OM
AgProtect_126	Salmonella_enterica_serovar_Typhi	Salmonella	Negative
AgProtect_1259	Mycobacterium_tuberculosis	Mycobacterium	Positive_with_OM
AgProtect_1258	Mycobacterium_tuberculosis	Mycobacterium	Positive_with_OM
AgProtect_1257	Mycobacterium_tuberculosis	Mycobacterium	Positive_with_OM
AgProtect_1256	Mycobacterium_tuberculosis	Mycobacterium	Positive_with_OM
AgProtect_1255	Mycobacterium_tuberculosis	Mycobacterium	Positive_with_OM
AgProtect_1254	Mycobacterium_tuberculosis	Mycobacterium	Positive_with_OM
AgProtect_1253	Mycobacterium_tuberculosis	Mycobacterium	Positive_with_OM
AgProtect_1252	Mycobacterium_tuberculosis	Mycobacterium	Positive_with_OM
AgProtect_1251	Mycobacterium_tuberculosis	Mycobacterium	Positive_with_OM
AgProtect_1250	Mycobacterium_tuberculosis	Mycobacterium	Positive_with_OM
AgProtect_125	Salmonella_enterica_serovar_Typhimurium	Salmonella	Negative
AgProtect_1249	Mycobacterium_tuberculosis	Mycobacterium	Positive_with_OM
AgProtect_1248	Mycobacterium_tuberculosis	Mycobacterium	Positive_with_OM
AgProtect_1247	Mycobacterium_tuberculosis	Mycobacterium	Positive_with_OM
AgProtect_1246	Mycobacterium_tuberculosis	Mycobacterium	Positive_with_OM
AgProtect_1245	Mycobacterium_tuberculosis	Mycobacterium	Positive_with_OM
AgProtect_1244	Mycoplasma_pneumoniae	Mycoplasma	Negative_without_OM
AgProtect_1243	Mycobacterium_tuberculosis	Mycobacterium	Positive_with_OM
AgProtect_1242	Mycobacterium_tuberculosis	Mycobacterium	Positive_with_OM
AgProtect_1241	Mycobacterium_tuberculosis	Mycobacterium	Positive_with_OM
AgProtect_1240	Mycobacterium_tuberculosis	Mycobacterium	Positive_with_OM
AgProtect_124	Shigella_flexneri	Shigella	Negative
AgProtect_1239	Mycobacterium_tuberculosis	Mycobacterium	Positive_with_OM
AgProtect_1238	Mycobacterium_tuberculosis	Mycobacterium	Positive_with_OM
AgProtect_1237	Mycobacterium_tuberculosis	Mycobacterium	Positive_with_OM
AgProtect_1236	Mycobacterium_tuberculosis	Mycobacterium	Positive_with_OM
AgProtect_1235	Mycobacterium_tuberculosis	Mycobacterium	Positive_with_OM
AgProtect_1234	Leptospira_interrogans	Leptospira	Negative
AgProtect_1233	Mycobacterium_tuberculosis	Mycobacterium	Positive_with_OM
AgProtect_1232	Helicobacter_pylori	Helicobacter	Negative
AgProtect_1231	Mycolicibacterium_paratuberculosis	Mycolicibacterium	Positive_with_OM
AgProtect_1230	Haemophilus_influenzae	Haemophilus	Negative
AgProtect_123	Shigella_flexneri	Shigella	Negative
AgProtect_1229	Haemophilus_influenzae	Haemophilus	Negative
AgProtect_1228	Haemophilus_influenzae	Haemophilus	Negative
AgProtect_1227	Mycobacterium_leprae	Mycobacterium	Positive_with_OM
AgProtect_1226	Porphyromonas_gingivalis	Porphyromonas	Negative
AgProtect_1225	Chlamydia_trachomatis	Chlamydia	Negative
AgProtect_1224	Borreliella_burgdorferi	Borreliella	Negative
AgProtect_1223	Neisseria_meningitidis	Neisseria	Negative
AgProtect_1222	Treponema_pallidum	Treponema	Negative
AgProtect_1221	Chlamydia_pneumoniae	Chlamydia	Negative
AgProtect_1220	Chlamydia_trachomatis	Chlamydia	Negative
AgProtect_122	Shigella_flexneri	Shigella	Negative
AgProtect_1219	Chlamydia_pneumoniae	Chlamydia	Negative
AgProtect_1218	Streptococcus_mutans	Streptococcus	Positive
AgProtect_1217	Chlamydia_trachomatis	Chlamydia	Negative
AgProtect_1216	Treponema_pallidum	Treponema	Negative
AgProtect_1215	Streptococcus_mutans	Streptococcus	Positive
AgProtect_1214	Mycoplasma_pneumoniae	Mycoplasma	Negative_without_OM
AgProtect_1213	Streptococcus_pyogenes	Streptococcus	Positive
AgProtect_1213	Streptococcus_pyogenes	Streptococcus	Positive
AgProtect_1212	Chlamydia_trachomatis	Chlamydia	Negative
AgProtect_1211	Chlamydia_trachomatis	Chlamydia	Negative
AgProtect_1210	Chlamydia_trachomatis	Chlamydia	Negative
AgProtect_121	Escherichia_coli	Escherichia	Negative
AgProtect_1209	Chlamydia_trachomatis	Chlamydia	Negative
AgProtect_1208	Borreliella_burgdorferi	Borreliella	Negative
AgProtect_1207	Borreliella_burgdorferi	Borreliella	Negative
AgProtect_1206	Coxiella_burnetii	Coxiella	Negative
AgProtect_1205	Escherichia_coli	Escherichia	Negative
AgProtect_1204	Helicobacter_pylori	Helicobacter	Negative
AgProtect_1203	Treponema_pallidum	Treponema	Negative
AgProtect_1202	Mycobacterium_tuberculosis	Mycobacterium	Positive_with_OM
AgProtect_1201	Mycobacterium_tuberculosis	Mycobacterium	Positive_with_OM
AgProtect_1200	Mycobacterium_tuberculosis	Mycobacterium	Positive_with_OM
AgProtect_120	Shigella_flexneri	Shigella	Negative
AgProtect_12	Chlamydia_abortus	Chlamydia	Negative
AgProtect_1199	Chlamydia_pneumoniae	Chlamydia	Negative
AgProtect_1198	Chlamydia_trachomatis	Chlamydia	Negative
AgProtect_1197	Chlamydia_trachomatis	Chlamydia	Negative
AgProtect_1196	Chlamydia_trachomatis	Chlamydia	Negative
AgProtect_1195	Chlamydia_trachomatis	Chlamydia	Negative
AgProtect_1194	Chlamydia_trachomatis	Chlamydia	Negative
AgProtect_1193	Chlamydia_trachomatis	Chlamydia	Negative
AgProtect_1192	Chlamydia_trachomatis	Chlamydia	Negative
AgProtect_1191	Chlamydia_trachomatis	Chlamydia	Negative
AgProtect_1190	Chlamydia_trachomatis	Chlamydia	Negative
AgProtect_119	Escherichia_coli	Escherichia	Negative
AgProtect_1189	Chlamydia_trachomatis	Chlamydia	Negative
AgProtect_1188	Chlamydia_trachomatis	Chlamydia	Negative
AgProtect_1187	Chlamydia_trachomatis	Chlamydia	Negative
AgProtect_1186	Chlamydia_trachomatis	Chlamydia	Negative
AgProtect_1185	Chlamydia_trachomatis	Chlamydia	Negative
AgProtect_1184	Chlamydia_trachomatis	Chlamydia	Negative
AgProtect_1183	Chlamydia_trachomatis	Chlamydia	Negative
AgProtect_1182	Chlamydia_trachomatis	Chlamydia	Negative
AgProtect_1181	Chlamydia_trachomatis	Chlamydia	Negative
AgProtect_1180	Chlamydia_trachomatis	Chlamydia	Negative
AgProtect_118	Escherichia_coli	Escherichia	Negative
AgProtect_1179	Chlamydia_trachomatis	Chlamydia	Negative
AgProtect_1178	Chlamydia_trachomatis	Chlamydia	Negative
AgProtect_1177	Chlamydia_trachomatis	Chlamydia	Negative
AgProtect_1176	Chlamydia_trachomatis	Chlamydia	Negative
AgProtect_1175	Chlamydia_trachomatis	Chlamydia	Negative
AgProtect_1174	Chlamydia_trachomatis	Chlamydia	Negative
AgProtect_1173	Chlamydia_trachomatis	Chlamydia	Negative
AgProtect_1172	Chlamydia_trachomatis	Chlamydia	Negative
AgProtect_1171	Chlamydia_trachomatis	Chlamydia	Negative
AgProtect_1170	Chlamydia_trachomatis	Chlamydia	Negative
AgProtect_117	Escherichia_coli	Escherichia	Negative
AgProtect_1169	Chlamydia_trachomatis	Chlamydia	Negative
AgProtect_1168	Chlamydia_trachomatis	Chlamydia	Negative
AgProtect_1167	Chlamydia_trachomatis	Chlamydia	Negative
AgProtect_1166	Mycobacterium_tuberculosis	Mycobacterium	Positive_with_OM
AgProtect_1165	Mycobacterium_tuberculosis	Mycobacterium	Positive_with_OM
AgProtect_1164	Mycobacterium_tuberculosis	Mycobacterium	Positive_with_OM
AgProtect_1163	Mycobacterium_tuberculosis	Mycobacterium	Positive_with_OM
AgProtect_1162	Mycobacterium_tuberculosis	Mycobacterium	Positive_with_OM
AgProtect_1161	Mycobacterium_tuberculosis	Mycobacterium	Positive_with_OM
AgProtect_1160	Mycobacterium_tuberculosis	Mycobacterium	Positive_with_OM
AgProtect_116	Escherichia_coli	Escherichia	Negative
AgProtect_1159	Mycobacterium_tuberculosis	Mycobacterium	Positive_with_OM
AgProtect_1158	Mycobacterium_tuberculosis	Mycobacterium	Positive_with_OM
AgProtect_1157	Mycobacterium_tuberculosis	Mycobacterium	Positive_with_OM
AgProtect_1156	Mycobacterium_tuberculosis	Mycobacterium	Positive_with_OM
AgProtect_1155	Mycobacterium_tuberculosis	Mycobacterium	Positive_with_OM
AgProtect_1154	Mycobacterium_tuberculosis	Mycobacterium	Positive_with_OM
AgProtect_1153	Mycobacterium_tuberculosis	Mycobacterium	Positive_with_OM
AgProtect_1152	Mycobacterium_tuberculosis	Mycobacterium	Positive_with_OM
AgProtect_1151	Mycobacterium_tuberculosis	Mycobacterium	Positive_with_OM
AgProtect_1150	Mycobacterium_tuberculosis	Mycobacterium	Positive_with_OM
AgProtect_115	Escherichia_coli	Escherichia	Negative
AgProtect_1149	Mycobacterium_tuberculosis	Mycobacterium	Positive_with_OM
AgProtect_1148	Mycobacterium_tuberculosis	Mycobacterium	Positive_with_OM
AgProtect_1147	Mycobacterium_tuberculosis	Mycobacterium	Positive_with_OM
AgProtect_1146	Mycobacterium_tuberculosis	Mycobacterium	Positive_with_OM
AgProtect_1145	Mycobacterium_tuberculosis	Mycobacterium	Positive_with_OM
AgProtect_1144	Mycobacterium_tuberculosis	Mycobacterium	Positive_with_OM
AgProtect_1143	Mycobacterium_tuberculosis	Mycobacterium	Positive_with_OM
AgProtect_1142	Mycobacterium_tuberculosis	Mycobacterium	Positive_with_OM
AgProtect_1141	Mycobacterium_tuberculosis	Mycobacterium	Positive_with_OM
AgProtect_1140	Mycobacterium_tuberculosis	Mycobacterium	Positive_with_OM
AgProtect_114	Escherichia_coli	Escherichia	Negative
AgProtect_1139	Mycobacterium_tuberculosis	Mycobacterium	Positive_with_OM
AgProtect_1138	Mycobacterium_tuberculosis	Mycobacterium	Positive_with_OM
AgProtect_1137	Mycobacterium_tuberculosis	Mycobacterium	Positive_with_OM
AgProtect_1136	Mycobacterium_tuberculosis	Mycobacterium	Positive_with_OM
AgProtect_1135	Mycobacterium_tuberculosis	Mycobacterium	Positive_with_OM
AgProtect_1134	Mycobacterium_tuberculosis	Mycobacterium	Positive_with_OM
AgProtect_1133	Mycobacterium_tuberculosis	Mycobacterium	Positive_with_OM
AgProtect_1132	Mycobacterium_tuberculosis	Mycobacterium	Positive_with_OM
AgProtect_1131	Borreliella_burgdorferi	Borreliella	Negative
AgProtect_1130	Borreliella_burgdorferi	Borreliella	Negative
AgProtect_113	Escherichia_coli	Escherichia	Negative
AgProtect_1129	Borreliella_burgdorferi	Borreliella	Negative
AgProtect_1128	Borreliella_burgdorferi	Borreliella	Negative
AgProtect_1127	Borreliella_burgdorferi	Borreliella	Negative
AgProtect_1126	Borreliella_burgdorferi	Borreliella	Negative
AgProtect_1125	Borreliella_burgdorferi	Borreliella	Negative
AgProtect_1124	Borreliella_burgdorferi	Borreliella	Negative
AgProtect_1123	Mycobacterium_tuberculosis	Mycobacterium	Positive_with_OM
AgProtect_1122	Mycobacterium_tuberculosis	Mycobacterium	Positive_with_OM
AgProtect_1121	Mycobacterium_tuberculosis	Mycobacterium	Positive_with_OM
AgProtect_1120	Mycobacterium_tuberculosis	Mycobacterium	Positive_with_OM
AgProtect_112	Escherichia_coli	Escherichia	Negative
AgProtect_1119	Mycobacterium_tuberculosis	Mycobacterium	Positive_with_OM
AgProtect_1118	Mycobacterium_tuberculosis	Mycobacterium	Positive_with_OM
AgProtect_1117	Mycobacterium_tuberculosis	Mycobacterium	Positive_with_OM
AgProtect_1116	Leptospira_interrogans	Leptospira	Negative
AgProtect_1115	Mycobacterium_tuberculosis	Mycobacterium	Positive_with_OM
AgProtect_1114	Mycobacterium_tuberculosis	Mycobacterium	Positive_with_OM
AgProtect_1113	Mycobacterium_tuberculosis	Mycobacterium	Positive_with_OM
AgProtect_1112	Mycobacterium_tuberculosis	Mycobacterium	Positive_with_OM
AgProtect_1111	Mycobacterium_tuberculosis	Mycobacterium	Positive_with_OM
AgProtect_1110	Mycobacterium_leprae	Mycobacterium	Positive_with_OM
AgProtect_111	Neisseria_meningitidis	Neisseria	Negative
AgProtect_1109	Mycobacterium_tuberculosis	Mycobacterium	Positive_with_OM
AgProtect_1108	Mycobacterium_tuberculosis	Mycobacterium	Positive_with_OM
AgProtect_1107	Mycobacterium_tuberculosis	Mycobacterium	Positive_with_OM
AgProtect_1106	Mycobacterium_tuberculosis	Mycobacterium	Positive_with_OM
AgProtect_1105	Mycobacterium_tuberculosis	Mycobacterium	Positive_with_OM
AgProtect_1104	Mycobacterium_tuberculosis	Mycobacterium	Positive_with_OM
AgProtect_1103	Mycobacterium_tuberculosis	Mycobacterium	Positive_with_OM
AgProtect_1102	Mycobacterium_tuberculosis	Mycobacterium	Positive_with_OM
AgProtect_1101	Mycobacterium_tuberculosis	Mycobacterium	Positive_with_OM
AgProtect_1100	Mycobacterium_tuberculosis	Mycobacterium	Positive_with_OM
AgProtect_110	Neisseria_meningitidis	Neisseria	Negative
AgProtect_11	Chlamydia_abortus	Chlamydia	Negative
AgProtect_1099	Mycobacterium_tuberculosis	Mycobacterium	Positive_with_OM
AgProtect_1098	Mycobacterium_tuberculosis	Mycobacterium	Positive_with_OM
AgProtect_1097	Mycobacterium_tuberculosis	Mycobacterium	Positive_with_OM
AgProtect_1096	Mycobacterium_tuberculosis	Mycobacterium	Positive_with_OM
AgProtect_1095	Mycobacterium_tuberculosis	Mycobacterium	Positive_with_OM
AgProtect_1094	Mycobacterium_tuberculosis	Mycobacterium	Positive_with_OM
AgProtect_1093	Mycobacterium_tuberculosis	Mycobacterium	Positive_with_OM
AgProtect_1092	Mycobacterium_tuberculosis	Mycobacterium	Positive_with_OM
AgProtect_1091	Mycobacterium_tuberculosis	Mycobacterium	Positive_with_OM
AgProtect_1090	Mycobacterium_tuberculosis	Mycobacterium	Positive_with_OM
AgProtect_109	Neisseria_meningitidis	Neisseria	Negative
AgProtect_1089	Mycobacterium_tuberculosis	Mycobacterium	Positive_with_OM
AgProtect_1088	Mycobacterium_tuberculosis	Mycobacterium	Positive_with_OM
AgProtect_1087	Mycobacterium_tuberculosis	Mycobacterium	Positive_with_OM
AgProtect_1086	Mycobacterium_tuberculosis	Mycobacterium	Positive_with_OM
AgProtect_1085	Mycobacterium_tuberculosis	Mycobacterium	Positive_with_OM
AgProtect_1084	Mycobacterium_tuberculosis	Mycobacterium	Positive_with_OM
AgProtect_1083	Mycobacterium_tuberculosis	Mycobacterium	Positive_with_OM
AgProtect_1082	Mycobacterium_tuberculosis	Mycobacterium	Positive_with_OM
AgProtect_1081	Mycobacterium_tuberculosis	Mycobacterium	Positive_with_OM
AgProtect_1080	Mycobacterium_tuberculosis	Mycobacterium	Positive_with_OM
AgProtect_108	Neisseria_meningitidis	Neisseria	Negative
AgProtect_1079	Mycobacterium_tuberculosis	Mycobacterium	Positive_with_OM
AgProtect_1078	Mycobacterium_tuberculosis	Mycobacterium	Positive_with_OM
AgProtect_1077	Mycobacterium_tuberculosis	Mycobacterium	Positive_with_OM
AgProtect_1076	Mycobacterium_tuberculosis	Mycobacterium	Positive_with_OM
AgProtect_1075	Mycobacterium_tuberculosis	Mycobacterium	Positive_with_OM
AgProtect_1074	Mycobacterium_tuberculosis	Mycobacterium	Positive_with_OM
AgProtect_1073	Mycobacterium_tuberculosis	Mycobacterium	Positive_with_OM
AgProtect_1072	Mycobacterium_tuberculosis	Mycobacterium	Positive_with_OM
AgProtect_1071	Mycobacterium_tuberculosis	Mycobacterium	Positive_with_OM
AgProtect_1070	Mycobacterium_tuberculosis	Mycobacterium	Positive_with_OM
AgProtect_107	Neisseria_meningitidis	Neisseria	Negative
AgProtect_1069	Mycobacterium_tuberculosis	Mycobacterium	Positive_with_OM
AgProtect_1068	Mycobacterium_tuberculosis	Mycobacterium	Positive_with_OM
AgProtect_1067	Mycobacterium_tuberculosis	Mycobacterium	Positive_with_OM
AgProtect_1066	Mycobacterium_tuberculosis	Mycobacterium	Positive_with_OM
AgProtect_1065	Mycobacterium_tuberculosis	Mycobacterium	Positive_with_OM
AgProtect_1064	Mycobacterium_tuberculosis	Mycobacterium	Positive_with_OM
AgProtect_1063	Mycobacterium_tuberculosis	Mycobacterium	Positive_with_OM
AgProtect_1062	Mycobacterium_tuberculosis	Mycobacterium	Positive_with_OM
AgProtect_1061	Mycobacterium_tuberculosis	Mycobacterium	Positive_with_OM
AgProtect_1060	Mycobacterium_tuberculosis	Mycobacterium	Positive_with_OM
AgProtect_106	Neisseria_meningitidis	Neisseria	Negative
AgProtect_1059	Mycobacterium_tuberculosis	Mycobacterium	Positive_with_OM
AgProtect_1058	Mycobacterium_tuberculosis	Mycobacterium	Positive_with_OM
AgProtect_1057	Mycobacterium_tuberculosis	Mycobacterium	Positive_with_OM
AgProtect_1056	Mycobacterium_tuberculosis	Mycobacterium	Positive_with_OM
AgProtect_1055	Mycobacterium_tuberculosis	Mycobacterium	Positive_with_OM
AgProtect_1054	Mycobacterium_tuberculosis	Mycobacterium	Positive_with_OM
AgProtect_1053	Mycobacterium_tuberculosis	Mycobacterium	Positive_with_OM
AgProtect_1052	Mycobacterium_tuberculosis	Mycobacterium	Positive_with_OM
AgProtect_1051	Mycobacterium_tuberculosis	Mycobacterium	Positive_with_OM
AgProtect_1050	Mycobacterium_tuberculosis	Mycobacterium	Positive_with_OM
AgProtect_105	Neisseria_meningitidis	Neisseria	Negative
AgProtect_1049	Mycobacterium_tuberculosis	Mycobacterium	Positive_with_OM
AgProtect_1048	Mycobacterium_tuberculosis	Mycobacterium	Positive_with_OM
AgProtect_1047	Mycobacterium_tuberculosis	Mycobacterium	Positive_with_OM
AgProtect_1046	Mycobacterium_tuberculosis	Mycobacterium	Positive_with_OM
AgProtect_1045	Mycobacterium_tuberculosis	Mycobacterium	Positive_with_OM
AgProtect_1044	Mycobacterium_tuberculosis	Mycobacterium	Positive_with_OM
AgProtect_1043	Mycobacterium_tuberculosis	Mycobacterium	Positive_with_OM
AgProtect_1042	Mycobacterium_tuberculosis	Mycobacterium	Positive_with_OM
AgProtect_1041	Mycobacterium_tuberculosis	Mycobacterium	Positive_with_OM
AgProtect_1040	Mycobacterium_tuberculosis	Mycobacterium	Positive_with_OM
AgProtect_104	Neisseria_meningitidis	Neisseria	Negative
AgProtect_1039	Mycobacterium_tuberculosis	Mycobacterium	Positive_with_OM
AgProtect_1038	Mycobacterium_tuberculosis	Mycobacterium	Positive_with_OM
AgProtect_1037	Mycobacterium_tuberculosis	Mycobacterium	Positive_with_OM
AgProtect_1036	Mycobacterium_tuberculosis	Mycobacterium	Positive_with_OM
AgProtect_1035	Mycobacterium_tuberculosis	Mycobacterium	Positive_with_OM
AgProtect_1034	Mycobacterium_tuberculosis	Mycobacterium	Positive_with_OM
AgProtect_1033	Mycobacterium_tuberculosis	Mycobacterium	Positive_with_OM
AgProtect_1032	Mycobacterium_tuberculosis	Mycobacterium	Positive_with_OM
AgProtect_1031	Mycobacterium_tuberculosis	Mycobacterium	Positive_with_OM
AgProtect_1030	Mycobacterium_tuberculosis	Mycobacterium	Positive_with_OM
AgProtect_103	Neisseria_meningitidis	Neisseria	Negative
AgProtect_1029	Mycobacterium_tuberculosis	Mycobacterium	Positive_with_OM
AgProtect_1028	Mycobacterium_tuberculosis	Mycobacterium	Positive_with_OM
AgProtect_1027	Mycobacterium_tuberculosis	Mycobacterium	Positive_with_OM
AgProtect_1026	Mycobacterium_tuberculosis	Mycobacterium	Positive_with_OM
AgProtect_1025	Mycobacterium_tuberculosis	Mycobacterium	Positive_with_OM
AgProtect_1024	Mycobacterium_tuberculosis	Mycobacterium	Positive_with_OM
AgProtect_1023	Mycobacterium_tuberculosis	Mycobacterium	Positive_with_OM
AgProtect_1022	Mycobacterium_tuberculosis	Mycobacterium	Positive_with_OM
AgProtect_1021	Mycobacterium_tuberculosis	Mycobacterium	Positive_with_OM
AgProtect_1020	Mycobacterium_tuberculosis	Mycobacterium	Positive_with_OM
AgProtect_102	Neisseria_meningitidis	Neisseria	Negative
AgProtect_1019	Mycobacterium_tuberculosis	Mycobacterium	Positive_with_OM
AgProtect_1018	Mycolicibacterium_paratuberculosis	Mycolicibacterium	Positive_with_OM
AgProtect_1017	Mycolicibacterium_paratuberculosis	Mycolicibacterium	Positive_with_OM
AgProtect_1016	Borreliella_burgdorferi	Borreliella	Negative
AgProtect_1015	Borreliella_burgdorferi	Borreliella	Negative
AgProtect_1014	Borreliella_burgdorferi	Borreliella	Negative
AgProtect_1013	Coxiella_burnetii	Coxiella	Negative
AgProtect_1012	Borreliella_burgdorferi	Borreliella	Negative
AgProtect_1011	Leptospira_interrogans	Leptospira	Negative
AgProtect_1010	Borreliella_afzelii	Borreliella	Negative
AgProtect_101	Brucella_abortus	Brucella	Negative
AgProtect_1009	Borreliella_afzelii	Borreliella	Negative
AgProtect_1008	Sporosarcina_newyorkensis	Sporosarcina	Positive
AgProtect_1007	Mycoplasmopsis_agalactiae	Mycoplasmopsis	Negative_without_OM
AgProtect_1006	Anaplasma_phagocytophilum	Anaplasma	Negative
AgProtect_1005	Anaplasma_phagocytophilum	Anaplasma	Negative
AgProtect_1004	Prescottella_equi	Prescottella	Positive_with_OM
AgProtect_1003	Olsenella_uli	Olsenella	Positive
AgProtect_1002	Moraxella_catarrhalis	Moraxella	Negative
AgProtect_1001	Moraxella_catarrhalis	Moraxella	Negative
AgProtect_1000	Anaplasma_marginale	Anaplasma	Negative
AgProtect_100	Brucella_abortus	Brucella	Negative
AgProtect_10	Chlamydophila_abortus	Chlamydophila	Negative
AgProtect_1	Brucella_abortus	Brucella	Negative
